Inertia Crimson Jewel->Инерция Багровый самоцвет
Inspired Learning Crimson Jewel->Перенятый опыт Багровый самоцвет
Rain of Splinters Crimson Jewel->Град обломков Багровый самоцвет
Efficient Training Crimson Jewel->Упорное обучение Багровый самоцвет
Atziri's Reign Crimson Jewel->Правление Атзири Багровый самоцвет
Fragility Crimson Jewel->Немощь Багровый самоцвет
Energised Armour Crimson Jewel->Энергетическая броня Багровый самоцвет
Emperor's Might Crimson Jewel->Могущество императора Багровый самоцвет
Grand Spectrum Crimson Jewel->Великий образ Багровый самоцвет
Primordial Might Crimson Jewel->Первородная мощь Багровый самоцвет
The Red Dream Crimson Jewel->Красный сон Багровый самоцвет
The Red Nightmare Crimson Jewel->Красный кошмар Багровый самоцвет
Might of the Meek Crimson Jewel->Сила кротких Багровый самоцвет
Tempered Flesh Crimson Jewel->Закалённая плоть Багровый самоцвет
Combat Focus Crimson Jewel->Мысли о бое Багровый самоцвет
Transcendent Flesh Crimson Jewel->Запредельная плоть Багровый самоцвет
Thread of Hope Crimson Jewel->Нить надежды Багровый самоцвет
Split Personality Crimson Jewel->Раздвоение личности Багровый самоцвет
Replica Primordial Might Crimson Jewel->Копия Первородной мощи Багровый самоцвет
Dissolution of the Flesh Crimson Jewel->Растворение плоти Багровый самоцвет
Forbidden Flame Crimson Jewel->Запретное пламя Багровый самоцвет
Thread of Hope Crimson Jewel->Нить надежды Багровый самоцвет
Grand Spectrum Crimson Jewel->Великий образ Багровый самоцвет
Grand Spectrum Crimson Jewel->Великий образ Багровый самоцвет
Firesong Crimson Jewel->Песть Пламени Багровый самоцвет
Immutable Force Crimson Jewel->Незыблемая сила Багровый самоцвет
Bloodnotch Crimson Jewel->Кровавый рубец Багровый самоцвет
Warrior's Tale Crimson Jewel->Сказ о воине Багровый самоцвет
That Which Was Taken Crimson Jewel->Присвоенное Багровый самоцвет
The Adorned Crimson Jewel->Былой блеск Багровый самоцвет
Replica Fragility Crimson Jewel->Копия Немощи Багровый самоцвет
Fluid Motion Viridian Jewel->Плавность движений Бирюзовый самоцвет
Intuitive Leap Viridian Jewel->Озарение Бирюзовый самоцвет
Lioneye's Fall Viridian Jewel->Падение Львиного глаза Бирюзовый самоцвет
Careful Planning Viridian Jewel->Осторожное планирование Бирюзовый самоцвет
Hidden Potential Viridian Jewel->Скрытый потенциал Бирюзовый самоцвет
Self-Flagellation Viridian Jewel->Самобичевание Бирюзовый самоцвет
Chill of Corruption Viridian Jewel->Холод скверны Бирюзовый самоцвет
Pacifism Viridian Jewel->Миролюбие Бирюзовый самоцвет
Emperor's Cunning Viridian Jewel->Коварство императора Бирюзовый самоцвет
Grand Spectrum Viridian Jewel->Великий образ Бирюзовый самоцвет
Primordial Eminence Viridian Jewel->Первородное господство Бирюзовый самоцвет
The Green Dream Viridian Jewel->Зеленый сон Бирюзовый самоцвет
The Green Nightmare Viridian Jewel->Зеленый кошмар Бирюзовый самоцвет
Pure Talent Viridian Jewel->Чистый талант Бирюзовый самоцвет
The Golden Rule Viridian Jewel->Золотое правило Бирюзовый самоцвет
Combat Focus Viridian Jewel->Мысли о бое Бирюзовый самоцвет
Tempered Spirit Viridian Jewel->Закалённый дух Бирюзовый самоцвет
Transcendent Spirit Viridian Jewel->Запредельный дух Бирюзовый самоцвет
Unnatural Instinct Viridian Jewel->Неестественный инстинкт Бирюзовый самоцвет
Seething Fury Viridian Jewel->Бурлящая ярость Бирюзовый самоцвет
Quickening Covenant Viridian Jewel->Оживляющее обязательство Бирюзовый самоцвет
Impossible Escape Viridian Jewel->Фантастическое спасение Бирюзовый самоцвет
Grand Spectrum Viridian Jewel->Великий образ Бирюзовый самоцвет
Grand Spectrum Viridian Jewel->Великий образ Бирюзовый самоцвет
Stormshroud Viridian Jewel->Грозовой покров Бирюзовый самоцвет
Ancestral Vision Viridian Jewel->Дальновидность предков Бирюзовый самоцвет
Replica Pacifism Viridian Jewel->Копия Миролюбия Бирюзовый самоцвет
To Dust Cobalt Jewel->В прах Кобальтовый самоцвет
Fertile Mind Cobalt Jewel->Изобретательность Кобальтовый самоцвет
Brute Force Solution Cobalt Jewel->Силовой подход Кобальтовый самоцвет
Fevered Mind Cobalt Jewel->Горячечный бред Кобальтовый самоцвет
Powerlessness Cobalt Jewel->Бессилие Кобальтовый самоцвет
Energy From Within Cobalt Jewel->Внутренние силы Кобальтовый самоцвет
Healthy Mind Cobalt Jewel->Здоровый дух Кобальтовый самоцвет
Dead Reckoning Cobalt Jewel->Возмездие мёртвых Кобальтовый самоцвет
Reckless Defence Cobalt Jewel->Дерзкая защита Кобальтовый самоцвет
Emperor's Wit Cobalt Jewel->Остроумие императора Кобальтовый самоцвет
Grand Spectrum Cobalt Jewel->Великий образ Кобальтовый самоцвет
Unending Hunger Cobalt Jewel->Неутолимый голод Кобальтовый самоцвет
Primordial Harmony Cobalt Jewel->Первородная гармония Кобальтовый самоцвет
The Blue Dream Cobalt Jewel->Синий сон Кобальтовый самоцвет
The Blue Nightmare Cobalt Jewel->Синий кошмар Кобальтовый самоцвет
Combat Focus Cobalt Jewel->Мысли о бое Кобальтовый самоцвет
Tempered Mind Cobalt Jewel->Закалённый разум Кобальтовый самоцвет
Transcendent Mind Cobalt Jewel->Запредельный разум Кобальтовый самоцвет
Fortress Covenant Cobalt Jewel->Крепостное обязательство Кобальтовый самоцвет
Replica Reckless Defence Cobalt Jewel->Копия Дерзкой защиты Кобальтовый самоцвет
Apex Mode Cobalt Jewel->Пиковый режим Кобальтовый самоцвет
Nadir Mode Cobalt Jewel->Низший режим Кобальтовый самоцвет
Melding of the Flesh Cobalt Jewel->Слияние плоти Кобальтовый самоцвет
Forbidden Flesh Cobalt Jewel->Запретная плоть Кобальтовый самоцвет
Grand Spectrum Cobalt Jewel->Великий образ Кобальтовый самоцвет
Grand Spectrum Cobalt Jewel->Великий образ Кобальтовый самоцвет
Witchbane Cobalt Jewel->Ведьмина погибель Кобальтовый самоцвет
Rational Doctrine Cobalt Jewel->Рациональная доктрина Кобальтовый самоцвет
The Balance of Terror Cobalt Jewel->Равновесие ужаса Кобальтовый самоцвет
Replica Powerlessness Cobalt Jewel->Копия Бессилия Кобальтовый самоцвет
Emperor's Mastery Prismatic Jewel->Господство императора Радужный самоцвет
The Anima Stone Prismatic Jewel->Камень внутренней сути Радужный самоцвет
Watcher's Eye Prismatic Jewel->Глаз хранителя Радужный самоцвет
Watcher's Eye Prismatic Jewel->Глаз хранителя Радужный самоцвет
Sublime Vision Prismatic Jewel->Возвышенный образ Радужный самоцвет
The Perandus Pact Prismatic Jewel->Пакт Перандусов Радужный самоцвет
Glorious Vanity Timeless Jewel->Блистательное тщеславие Вневременной самоцвет
Militant Faith Timeless Jewel->Воинственная вера Вневременной самоцвет
Brutal Restraint Timeless Jewel->Жестокая сдержанность Вневременной самоцвет
Elegant Hubris Timeless Jewel->Изящный эготизм Вневременной самоцвет
Lethal Pride Timeless Jewel->Смертельная гордость Вневременной самоцвет
Voices Large Cluster Jewel->Голоса Большой кластерный самоцвет
Voices Large Cluster Jewel->Голоса Большой кластерный самоцвет
Voices Large Cluster Jewel->Голоса Большой кластерный самоцвет
Voices Large Cluster Jewel->Голоса Большой кластерный самоцвет
Megalomaniac Medium Cluster Jewel->Мания величия Средний кластерный самоцвет
One With Nothing Small Cluster Jewel->Без ничего Малый кластерный самоцвет
Adds Hollow Palm Technique->Добавляет ключевое умение Техника пустой длани
Kitava's Teachings Small Cluster Jewel->Учение Китавы Малый кластерный самоцвет
Adds Disciple of Kitava->Добавляет значимое умение Адепт Китавы
The Interrogation Small Cluster Jewel->Допрос Малый кластерный самоцвет
Adds Secrets of Suffering->Катастрофические видения Малый кластерный самоцвет
Calamitous Visions Small Cluster Jewel->Добавляет ключевое умение Одинокий посланник
Adds Lone Messenger->Природное родство Малый кластерный самоцвет
Natural Affinity Small Cluster Jewel->Добавляет ключевое умение Терпеливость природы
Adds Nature's Patience->Осада Малый кластерный самоцвет
The Siege Small Cluster Jewel->Добавляет ключевое умение Кинетика
Adds Kineticism->Авангард Малый кластерный самоцвет
The Front Line Small Cluster Jewel->Добавляет ключевое умение Предчувствие ветерана
Coralito's Signature Diamond Flask->Почерк Коралито Алмазный флакон
Coruscating Elixir Ruby Flask->Сверкающий эликсир Рубиновый флакон
Dying Sun Ruby Flask->Умирающее солнце Рубиновый флакон
Taste of Hate Sapphire Flask->Вкус ненависти Сапфировый флакон
Vessel of Vinktar Topaz Flask->Сосуд Винктара Топазовый флакон
Vessel of Vinktar Topaz Flask->Сосуд Винктара Топазовый флакон
Vessel of Vinktar Topaz Flask->Сосуд Винктара Топазовый флакон
Vessel of Vinktar Topaz Flask->Сосуд Винктара Топазовый флакон
Vessel of Vinktar Topaz Flask->Сосуд Винктара Топазовый флакон
Rumi's Concoction Granite Flask->Отвар Руми Гранитный флакон
Lion's Roar Granite Flask->Львиный рёв Гранитный флакон
Replica Rumi's Concoction Granite Flask->Копия Отвара Руми Гранитный флакон
Rotgut Quicksilver Flask->Пойло Ртутный флакон
Atziri's Promise Amethyst Flask->Обещание Атзири Аметистовый флакон
Progenesis Amethyst Flask->Прогенез Аметистовый флакон
Forbidden Taste Quartz Flask->Запретный вкус Кварцевый флакон
Soul Catcher Quartz Flask->Душелов Кварцевый флакон
Soul Ripper Quartz Flask->Жнец душ Кварцевый флакон
Witchfire Brew Stibnite Flask->Отвар ведьмовского огня Стибнитовый флакон
Grants Level 21 Despair Curse Aura during Effect->Дарует ауру проклятия Отчаяние 21 уровня во время действия эффекта
Sin's Rebirth Stibnite Flask->Возрождение Греха Стибнитовый флакон
Unholy Might during Effect->Дает Нечестивое могущество на время действия эффекта
Replica Witchfire Brew Stibnite Flask->Копия Отвара ведьмовского огня Стибнитовый флакон
The Sorrow of the Divine Sulphur Flask->Печаль божества Серный флакон
Zealot's Oath during Effect->Обет фанатика во время действия эффекта
The Overflowing Chalice Sulphur Flask->Переполненная чаша Серный флакон
Bottled Faith Sulphur Flask->Вера в бутылке Серный флакон
Replica Sorrow of the Divine Sulphur Flask->Копия Печали божества Серный флакон
Eldritch Battery during Effect->Мистический накопитель во время действия флакона
Kiara's Determination Silver Flask->Решимость Киары Серебряный флакон
Cinderswallow Urn Silver Flask->Урна глотателя пепла Серебряный флакон
The Wise Oak Bismuth Flask->Мудрый дуб Висмутовый флакон
Oriath's End Bismuth Flask->Исход Ориата Висмутовый флакон
Olroth's Resolve Iron Flask->Решительность Олрота Железный флакон
Starlight Chalice Iron Flask->Чаша звёздного света Железный флакон
Elixir of the Unbroken Circle Iron Flask->Эликсир сомкнутого круга Железный флакон
Vorana's Preparation Iron Flask->Подготовка Вораны Железный флакон
Three Faces in the Dark->Три лика в темноте
The Doctor->Доктор
The Hermit->Отшельник
Lantador's Lost Love->Утраченная любовь Лантадора
The Metalsmith's Gift->Дар кузнеца
The Battle Born->Воитель
The Gladiator->Гладиатор
The Scholar->Учёный
The Brittle Emperor->Хрупкий император
The Poet->Поэт
The Carrion Crow->Чёрный ворон
Hope->Надежда
The Fiend->Враг
Birth of the Three->Рождение трёх
Vinia's Token->Знак Винии
The Summoner->Призыватель
The Cataclysm->Катаклизм
The Hunger->Голод
The Hoarder->Скопидом
The Drunken Aristocrat->Пьяный патриций
The Sun->Солнце
The Warden->Смотритель
The Scarred Meadow->Выгоревший луг
The Dark Mage->Тёмный маг
The Gemcutter->Камнерезчик
The Gambler->Игрок
The Lover->Любовник
Chaotic Disposition->Баламут
The Road to Power->Путь к власти
The Avenger->Мститель
Emperor's Luck->Удача императора
Time-Lost Relic->Утерянная реликвия
Lucky Connections->Удачная сделка
The Feast->Пир
Rain of Chaos->Пришествие хаоса
The Watcher->Наблюдатель
The Incantation->Песнопение
Coveted Possession->Упоение
The King's Heart->Сердце вождя
Abandoned Wealth->Забытое богатство
The Wind->Ветер
The Pact->Пакт
Gemcutter's Promise->Клятва камнерезчика
The Celestial Justicar->Небесный судья
The Chains that Bind->Оковы
The Artist->Художник
The Inventor->Изобретатель
The Pack Leader->Вожак стаи
Jack in the Box->Сюрприз
The Union->Союз
The Queen->Царица
Humility->Смирение
The Explorer->Исследователь
The Spoiled Prince->Баловень
The Betrayal->Предательство
The Flora's Gift->Сила природы
The Siren->Сирена
The One With All->Единство
The Last One Standing->Последний воин
Doedre's Madness->Безумие Доэдре
The Encroaching Darkness->Вездесущая тьма
The Wrath->Гнев
The King's Blade->Клинок Венценосца
The Trial->Испытание
The Gentleman->Джентльмен
House of Mirrors->Зеркальный лабиринт
Wealth and Power->Богатство и власть
The Catalyst->Катализатор
The Vast->Простор
Gift of the Gemling Queen->Дары царицы каменитов
The Dragon's Heart->Сердце дракона
The Fox->Лиса
The Doppelganger->Двойник
The Survivalist->Выживший
Death->Смерть
Grave Knowledge->Загробное знание
The Jester->Шут
The Mercenary->Наёмник
The Inoculated->Инокулированный
Loyalty->Верность
Pride Before the Fall->Гордыня
Audacity->Наглость
Assassin's Favour->Услуга душегуба
Hunter's Resolve->Решение охотника
Scholar of the Seas->Мореплаватель
The Conduit->Проводник
The Tower->Башня
The Twins->Близнецы
Anarchy's Price->Цена анархии
The Lich->Лич
The Thaumaturgist->Чудотворец
The Aesthete->Эстет
The Enlightened->Просветлённый
Hunter's Reward->Трофей охотника
The Fletcher->Пронзатель
The Surveyor->Топограф
Bowyer's Dream->Мечта лучника
The Surgeon->Хирург
Volatile Power->Изменчивая сила
Last Hope->Последняя надежда
Hubris->Высокомерие
Blind Venture->Сделка вслепую
Merciless Armament->Безжалостное орудие
The Cartographer->Картограф
The Warlord->Воевода
The Demoness->Демоница
The Traitor->Предатель
The Offering->Подношение
Lost Worlds->Затерянные миры
The Lord in Black->Господин в чёрном
A Mother's Parting Gift->Прощальный дар матери
The Body->Тело
Turn the Other Cheek->Подставь другую щёку
Glimmer of Hope->Проблеск надежды
The Ethereal->Эфемерность
Prosperity->Богатство
The Sigil->Печать
The Dapper Prodigy->Одарённый франт
The Rabid Rhoa->Бешеный Роа
The Soul->Душа
The Lion->Лев
The Dragon->Дракон
Rats->Крысы
The Risk->Риск
Tranquillity->Спокойствие
Her Mask->Её маска
Treasure Hunter->Охотник за сокровищами
Earth Drinker->Пьющий землю
The Wolf's Shadow->Тень Волка
The Arena Champion->Чемпион Арены
The Sephirot->Сефирот
The Visionary->Провидец
Thunderous Skies->Небесный гром
Dying Anguish->Смертельная тоска
The Immortal->Бессмертный
The Throne->Престол
Boundless Realms->Бескрайние владения
The Devastator->Разрушитель
Destined to Crumble->Неизбежный крах
Shard of Fate->Осколок рока
Heterochromia->Гетерохромия
Rain Tempter->Дождь-искуситель
The Void->Ничто
The Tyrant->Тиран
The Web->Паутина
The Harvester->Жнец
The Lunaris Priestess->Жрица Лунарис
Emperor of Purity->Император Чистоты
The Cursed King->Проклятый монарх
The Stormcaller->Призыватель бури
Lysah's Respite->Передышка Лисы
Cartographer's Delight->Восторг картографа
Lucky Deck->Счастливая колода
Light and Truth->Свет и правда
Luck of the Vaal->Удача ваал
The Endurance->Выносливость
The Penitent->Кающийся
The Wolf->Волк
Dialla's Subjugation->Подчинение Диаллы
The Calling->Призыв
The Valkyrie->Валькирия
The Formless Sea->Бесформенное море
The Oath->Клятва
The Scavenger->Падальщик
Mawr Blaidd->Mawr Blaidd
The Porcupine->Дикобраз
The Coming Storm->Канун бури
The Polymath->Полимат
The Wolverine->Росомаха
Mitts->Рукавички
The Wretched->Горемыка
The Wolven King's Bite->Укус Волчьего короля
The Standoff->Противоборство
The Forsaken->Забытые
The Garish Power->Крикливая мощь
Lingering Remnants->Пережитки прошлого
The Spark and the Flame->Искра и пламя
The Saint's Treasure->Сокровище святоши
Call to the First Ones->Призыв Первых
The Valley of Steel Boxes->Долина стальных ларей
Might is Right->Правда в силе
The Opulent->Толстосум
Struck by Lightning->Поражённый молнией
Atziri's Arsenal->Арсенал Атзири
The Ruthless Ceinture->Беспощадный ремень
No Traces->Без следа
The Realm->Царство
The Eye of the Dragon->Глаз дракона
The Blazing Fire->Пылающий огонь
Left to Fate->На произвол судьбы
Rebirth->Перерождение
The Insatiable->Ненасытный
The Obscured->Скрытный
The Rusted Bard->Ржавый бард
Forbidden Power->Запретная сила
The Breach->Разлом
The Dreamer->Сновидец
The World Eater->Пожиратель миров
The Deceiver->Обманщик
Blessing of God->Благословение Господа
The Puzzle->Головоломка
The Witch->Ведьма
Immortal Resolve->Бессмертная решимость
The Jeweller's Boon->Благо ювелира
The Darkest Dream->Темнейший сон
The Master->Хозяин
The Fathomless Depths->Бездонные глубины
The Undaunted->Неустрашимый
The Admirer->Поклонник
The Sword King's Salute->Дань Венценосца мечей
The Army of Blood->Армия крови
The Celestial Stone->Небесный камень
Perfection->Идеал
The Dreamland->Страна грёз
Harmony of Souls->Гармония душ
The Samurai's Eye->Око самурая
The Hale Heart->Крепкое сердце
The Mayor->Правитель
The Undisputed->Неоспоримый
The Rite of Elements->Ритуал стихий
Three Voices->Три голоса
The Professor->Профессор
The Beast->Зверь
The Innocent->Невинный
The Wilted Rose->Увядшая роза
The Endless Darkness->Бесконечная тьма
Beauty Through Death->Посмертная красота
The Price of Protection->Цена защиты
Boon of the First Ones->Дар Первых
The Twilight Moon->Луна в сумерках
The Cacophony->Какофония
The Sacrifice->Жертвоприношение
A Dab of Ink->Капля чернил
The Nurse->Медсестра
The Master Artisan->Мастер-ремесленник
The Life Thief->Похититель жизни
The Seeker->Искатель
The Messenger->Посланник
The Mad King->Безумный царь
Boon of Justice->Дар правосудия
The Journey->Путешествие
Arrogance of the Vaal->Высокомерие ваал
The Landing->Приземление
The Mountain->Гора
Seven Years Bad Luck->Семь лет неудач
The Golden Era->Золотой век
Monochrome->Монохромность
Dark Temptation->Тёмное искушение
Alone in the Darkness->Один в темноте
Sambodhi's Vow->Клятва Самбодхи
The Lord of Celebration->Владыка триумфа
Vanity->Тщеславие
Imperial Legacy->Имперское наследие
Burning Blood->Горящая кровь
The Primordial->Первородный
Echoes of Love->Отголоски любви
Thirst for Knowledge->Жажда знаний
Alluring Bounty->Соблазнительная награда
The Fool->Дурак
Pride of the First Ones->Гордость Первых
The Deep Ones->Глубокие
The Archmage's Right Hand->Правая рука Архимага
Dark Dreams->Тёмные мечты
Buried Treasure->Спрятанное сокровище
Demigod's Wager->Пари полубога
The Old Man->Старик
Nook's Crown->Корона Нука
The Side Quest->Побочное задание
The Price of Loyalty->Цена преданности
The Heroic Shot->Героическая попытка
Remembrance->Поминовение
More is Never Enough->Большего всегда мало
Vile Power->Злая мощь
The Bargain->Сделка
Azyran's Reward->Награда Азирана
The Skeleton->Скелет
The Eye of Terror->Око ужаса
The Demon->Демон
Akil's Prophecy->Пророчество Акила
The Damned->Проклятые
Void of the Elements->Стихийная пустота
The Deal->Соглашение
The Wolf's Legacy->Волчье наследие
Baited Expectations->Искушающие ожидания
Succor of the Sinless->Помощь безгрешных
Underground Forest->Подземный лес
The Escape->Побег
Deathly Designs->Смертельные замыслы
The Chosen->Избранный
Cameria's Cut->Доля Камерии
Divine Justice->Божественное правосудие
The Fishmonger->Торговец рыбой
The Bones->Кости
Friendship->Дружба
The Craving->Стремление
Etched in Blood->Выгравированные в крови
Squandered Prosperity->Растраченное богатство
The Strategist->Стратег
The Cheater->Ловкач
The Tinkerer's Table->Верстак умельца
The Easy Stroll->Лёгкая прогулка
The Progeny of Lunaris->Потомок Лунарис
The Eldritch Decay->Аномальное увядание
Council of Cats->Кошачий совет
The Tumbleweed->Перекати-поле
The Hive of Knowledge->Скопище знаний
Gift of Asenath->Подарок Азенат
A Note in the Wind->Музыка на ветру
The Greatest Intentions->Величайшие намерения
The White Knight->Белый рыцарь
Prometheus' Armoury->Кузня Прометея
The Sustenance->Пропитание
Peaceful Moments->Безмятежные минуты
The Awakened->Пробуждённые
A Familiar Call->Знакомый зов
The Long Con->Долгое собрание
The Gulf->Пропасть
The Bitter Blossom->Колючее соцветие
Triskaidekaphobia->Трискайдекафобия
Unrequited Love->Безответная любовь
The Cache->Тайник
The Academic->Академик
Desecrated Virtue->Осквернённая добродетель
Brother's Stash->Братские сбережения
Unchained->Освобождённый
The Unexpected Prize->Неожиданная награда
Cursed Words->Проклятые слова
The Journalist->Журналист
Haunting Shadows->Преследующие тени
Acclimatisation->Акклиматизация
The Whiteout->Белая пелена
Society's Remorse->Укоризна общества
Dying Light->Угасающий свет
Fateful Meeting->Судьбоносная встреча
The Astromancer->Астромант
Keeper's Corruption->Порочность хранителя
Reckless Ambition->Дерзкие амбиции
Love Through Ice->Любовь сквозь лёд
Draped in Dreams->Облачённый в мечты
The Patient->Пациент
The Long Watch->Долгий дозор
The Bear Woman->Женщина-медведь
Brotherhood in Exile->Собратья по изгнанию
Winter's Embrace->Объятья зимы
Sambodhi's Wisdom->Мудрость Самбодхи
The Enthusiasts->Энтузиасты
Broken Promises->Нарушенные обещания
Brush, Paint and Palette->Кисть, краска и палитра
Deadly Joy->Смертоносное веселье
The Adventuring Spirit->Дух приключений
The Eternal War->Вечная война
Prejudice->Предрассудки
The Shortcut->Кратчайший путь
The Card Sharp->Шулер
A Modest Request->Скромная просьба
Luminous Trove->Светящийся клад
The Hook->Крючок
The Last Supper->Последний ужин
The Emptiness->Пустота
A Sea of Blue->Синее море
The Offspring->Потомство
The Price of Prescience->Цена предвидения
The Mind's Eyes->Глаза разума
Terrible Secret of Space->Ужасная тайна космоса
The Blessing of Moosh->Благословение Муши
Costly Curio->Ценный раритет
Lachrymal Necrosis->Бездушие
Dementophobia->Дементофобия
Ambitious Obsession->Амбициозная одержимость
Desperate Crusade->Отчаянный поход
A Stone Perfected->Совершенный камень
Treasures of the Vaal->Сокровища ваал
The Rabbit's Foot->Кроличья лапка
Chasing Risk->В погоне за риском
The Prince of Darkness->Князь тьмы
The Catch->Улов
Eternal Bonds->Вечные узы
Disdain->Презрение
The Scout->Разведчик
Guardian's Challenge->Испытание Хранителя
The Forgotten Treasure->Забытое сокровище
The Fox in the Brambles->Лис в терновнике
The Aspirant->Претендент
Judging Voices->Осуждающие голоса
Bijoux->Драгоценности
Silence and Frost->Молчание и хлад
Misery in Darkness->Страдания в темноте
The Tireless Extractor->Безустанный экстрактор
Justified Ambition->Оправданные амбиции
Parasitic Passengers->Паразитирующие пассажиры
Duality->Двойственность
The One That Got Away->Неуловимая добыча
The Transformation->Преображение
Magnum Opus->Магнум опус
Imperfect Memories->Несовершенные воспоминания
The Magma Crab->Магмовый краб
Altered Perception->Изменённое восприятие
Further Invention->Новое изобретение
The Brawny Battle Mage->Дюжий волшебник
A Fate Worse Than Death->Участь хуже смерти
The Destination->Цель путешествия
Rebirth and Renewal->Возрождение и обновление
The Forward Gaze->Взгляд вперёд
The Apothecary->Аптекарь
Home->Дом
The Dungeon Master->Тюремщик
From Bone to Ashes->От костей к пеплу
Darker Half->Тёмная половина
Broken Truce->Нарушенное перемирие
Doryani's Epiphany->Прозрение Дориани
Endless Night->Бесконечная ночь
The Shieldbearer->Щитоносец
Choking Guilt->Удушающая вина
The Enforcer->Исполнитель
The Shepherd's Sandals->Сандалии пастуха
Azure Rage->Лазурная ярость
The Leviathan->Левиафан
The Price of Devotion->Цена послушания
Astral Protection->Астральная защита
Gemcutter's Mercy->Счастье камнереза
Checkmate->Шах и мат
Lethean Temptation->Летейское искушение
Something Dark->Нечто тёмное
Man With Bear->Человек с медведем
Alivia's Grace->Доброта Аливии
Auspicious Ambitions->Многообещающие амбиции
Divine Beauty->Божественная красота
The Wedding Gift->Подарок на свадьбу
The Insane Cat->Безумная кошка
Ever-Changing->Бесконечные перемены
A Dusty Memory->Пыльное воспоминание
The Return of the Rat->Возвращение крысы
The Finishing Touch->Завершающий штрих
Brother's Gift->Подарок брата
Soul Quenched->Насыщение душами
Poisoned Faith->Отравленная вера
A Chilling Wind->Пронизывающий ветер
Matryoshka->Матрёшка
The Fortunate->Счастливец
Fire Of Unknown Origin->Огонь незнамо откуда
His Judgement->Его приговор
Who Asked->Просители
Eldritch Perfection->Мистический идеал
Assassin's Gift->Подарок убийцы
I See Brothers->Я вижу братьев
Whispering Incubator->Шепчущий инкубатор
Fine Incubator->Прекрасный инкубатор
Singular Incubator->Необычный инкубатор
Cartographer's Incubator->Инкубатор картографа
Otherworldly Incubator->Потусторонний инкубатор
Abyssal Incubator->Инкубатор Бездны
Fragmented Incubator->Раздробленный инкубатор
Skittering Incubator->Дергающийся инкубатор
Infused Incubator->Заряженный инкубатор
Fossilised Incubator->Ископаемый инкубатор
Kalguuran Incubator->Калгууранский инкубатор
Diviner's Incubator->Инкубатор предсказателя
Primal Incubator->Первобытный инкубатор
Enchanted Incubator->Зачарованный инкубатор
Geomancer's Incubator->Инкубатор геоманта
Ornate Incubator->Изысканный инкубатор
Time-Lost Incubator->Затерянный во времени инкубатор
Celestial Armoursmith's Incubator->Небесный инкубатор бронника
Celestial Blacksmith's Incubator->Небесный инкубатор кузнеца
Celestial Jeweller's Incubator->Небесный инкубатор ювелира
Eldritch Incubator->Мистический инкубатор
Obscured Incubator->Затемнённый инкубатор
Foreboding Incubator->Таинственный инкубатор
Thaumaturge's Incubator->Инкубатор волшебника
Mysterious Incubator->Загадочный инкубатор
Gemcutter's Incubator->Инкубатор камнереза
Feral Incubator->Дикий инкубатор
Blighted Incubator->Заражённый инкубатор
Challenging Incubator->Испытующий инкубатор
Maddening Incubator->Одержимый инкубатор
Replica Abyssus Ezomyte Burgonet->Копия Бездны Полный шлем эзомита
Replica Advancing Fortress Gut Ripper->Копия Ходячей крепости Вспарыватель
Replica Alberon's Warpath Soldier Boots->Копия Тропы войны Алберона Сапоги ауксилария
Replica Allelopathy Satin Gloves->Копия Аллелопатии Сатиновые перчатки
Grants Level 22 Wintertide Brand Skill->Дарует умение Клеймо зимы 22 уровня
Replica Allure Vaal Claw->Копия Соблазна Коготь ваал
Replica Alpha's Howl Sinner Tricorne->Копия Воя Альфы Треуголка грешника
Replica Ambu's Charge Crusader Chainmail->Копия Ража Амбу Кольчуга святого воина
Replica Atziri's Acuity Vaal Gauntlets->Копия Проницательности Атзири Перчатки ваал
You have Perfect Agony if you've dealt a Critical Strike recently->Копия Причуды Атзири Амулет из ракушек
Replica Atziri's Foible Paua Amulet->Копия Знака Братства Амулет с бирюзой
Replica Badge of the Brotherhood Turquoise Amulet->Копия Затаённого дыхания Цепочка
Replica Bated Breath Chain Belt->Копия Горькой мечты Скипетр тени
Replica Bitterdream Shadow Sceptre->Размещённые камни усилены Жертвенностью 15 уровня
Replica Blood Sacrifice Crimson Jewel->Размещенные камни усилены Вдохновением 15 уровня
Replica Blood Thorn Gnarled Branch->Размещённые камни усилены Возбуждением 15 уровня
Replica Bloodplay Stiletto->Копия Кровавой жертвы Багровый самоцвет
Replica Bones of Ullr Silk Slippers->Копия Кровавого шипа Сучковатая ветка
Replica Cheap Construction Viridian Jewel->Копия Игры крови Стилет
Replica Cold Iron Point Ezomyte Dagger->Копия Костей Уллра Шёлковые сапоги
Replica Conqueror's Efficiency Crimson Jewel->Копия Дешёвой сборки Бирюзовый самоцвет
Replica Cortex Synthesised Map->Копия Острия холодного железа Кинжал эзомита
Replica Covenant Spidersilk Robe->Копия Смекалки победителя Багровый самоцвет
Replica Doedre's Damning Paua Ring->Копия Коры Синтезированная карта
Replica Dreamfeather Eternal Sword->Копия Договора Одеяние из паучьего шёлка
Replica Duskdawn Maelstrom Staff->Копия Проклятия Доэдре Кольцо с ракушкой
Replica Earendel's Embrace Grinning Fetish->Копия Пера грёз Меч вечного
Replica Emberwake Ruby Ring->Копия Сумеречного рассвета Посох вихрей
Replica Eternity Shroud Blood Raiment->Копия Объятий Эарендила Оскаленный фетиш
Trigger Level 20 Shade Form when Hit->Копия Огненного следа Кольцо с рубином
Replica Farrul's Fur Triumphant Lamellar->Копия Покрова вечности Кровавый камзол
Aspect of the Cat has no Reservation->Дух кошки не удерживает ресурсы
Replica Fencoil Gnarled Branch->Копия Болотной коряги Сучковатая ветка
Replica Forbidden Shako Great Crown->Копия Запрещённого кивера Большая корона
Replica Fragile Bloom Crimson Jewel->Копия Нежного цветка Багровый самоцвет
Replica Fragility Crimson Jewel->Копия Немощи Багровый самоцвет
Replica Frostbreath Ornate Mace->Копия Ледяного дыхания Украшенная булава
Replica Grip of the Council Arcanist Gloves->Копия Хватки Совета Перчатки тайнописца
Replica Harvest Jasper Chopper->Копия Жатвы Яшмовое рубило
Replica Headhunter Leather Belt->Копия Охотника за головами Ремень
Replica Heartbreaker Royal Skean->Копия Губителя сердец Кинжал царя
Replica Heatshiver Leather Hood->Копия Льда и пламени Кожаный капюшон
Replica Hinekora's Sight Onyx Amulet->Копия Взгляда Хинекоры Амулет с ониксом
Replica Hotheaded Viridian Jewel->Копия Запальчивости Бирюзовый самоцвет
Replica Hyrri's Ire Zodiac Leather->Копия Ярости Хайрри Кожаный доспех зодиака
Replica Hyrri's Truth Jade Amulet->Копия Правды Хайрри Амулет с нефритом
Grants Level 22 Hatred Skill->Дарует умение Холодная ненависть 22 уровня
Replica Infractem Decimation Bow->Копия Инфрактама Лук палача
Replica Innsbury Edge Elder Sword->Копия Клинка Иннсбери Меч старейшины
Replica Inya's Epiphany Arcanist Slippers->Копия Прозрения Иньи Сапоги тайнописца
Replica Iron Commander Death Bow->Копия Сурового командира Лук смерти
Shrapnel Ballista has +1 to maximum number of Summoned Totems per 200 Strength->Осколочная баллиста имеет +1 к максимальному количеству установленных тотемов за каждые 200 силы
Replica Kalisa's Grace Samite Gloves->Копия Благодати Калисы Атласные перчатки
Replica Kaom's Heart Glorious Plate->Размещенные камни усилены Высвобождением 18 уровня
Replica Karui Ward Jade Amulet->Копия Сердца Каома Великолепные латы
Replica Kongor's Undying Rage Terror Maul->Копия Оберега каруи Амулет с нефритом
Replica Last Resort Nailed Fist->Копия Вечной ярости Конгора Чудовищный молот
Replica Lavianga's Spirit Sanctified Mana Flask->Копия Последнего средства Шипастый кулак
Replica Leer Cast Festival Mask->Копия Духа Лавианги Святой флакон маны
Replica Lioneye's Paws Bronzescale Boots->Копия Маски труппы хитрецов Карнавальная маска
Trigger Level 5 Toxic Rain when you Attack with a Bow->Копия Лап Львиного глаза Бронзовые ботинки
Replica Loreweave Elegant Ringmail->Копия Плетения преданий Изящный кольчатый доспех
Replica Malachai's Artifice Unset Ring->Копия Уловки Малахая Кольцо без камня
Socketed Gems have Secrets of Suffering->Размещенные камни имеют эффект Секреты страдания
Replica Maloney's Mechanism Ornate Quiver->Копия Механизма Мэлоуни Витиеватый колчан
Replica Midnight Bargain Engraved Wand->Копия Полуночной сделки Резной жезл
Cannot be used with Chaos Inoculation->Копия Стены тумана Многослойный баклер
Replica Mistwall Lacquered Buckler->Копия Небулиса Скипетр пустоты
Replica Nebulis Void Sceptre->Копия Жертвы Оро Меч подземного царства
Replica Oro's Sacrifice Infernal Sword->Копия Миролюбия Бирюзовый самоцвет
Replica Pacifism Viridian Jewel->Копия Парадоксики Рапира ваал
Replica Paradoxica Vaal Rapier->Копия Идеальной формы Кожаный доспех зодиака
Replica Perfect Form Zodiac Leather->Копия Столпов Арун Карта дюн
Replica Pillars of Arun Dunes Map->Копия Богадельни Паршута Карта храма
Replica Poorjoy's Asylum Temple Map->Копия Бессилия Кобальтовый самоцвет
Replica Powerlessness Cobalt Jewel->Копия Первородной мощи Багровый самоцвет
Replica Primordial Might Crimson Jewel->Копия Сплетения цвета Кушак
Replica Prismweave Rustic Sash->Копия Чистого таланта Бирюзовый самоцвет
Replica Pure Talent Viridian Jewel->Копия Ливня перьев Короткий лук
Replica Quill Rain Short Bow->Копия Дерзкой защиты Кобальтовый самоцвет
Replica Reckless Defence Cobalt Jewel->Копия Красного следа Поножи титана
Replica Red Trail Titan Greaves->Копия Неусыпной опеки Кровожадный доспех
Replica Restless Ward Carnal Armour->Копия Отвара Руми Гранитный флакон
Replica Rumi's Concoction Granite Flask->Копия Савана бессветных Кровожадный доспех
Replica Shroud of the Lightless Carnal Armour->Копия Конца осаде Широкий ремень
Replica Siegebreaker Heavy Belt->Копия Печали божества Серный флакон
Replica Sorrow of the Divine Sulphur Flask->Мистический накопитель во время действия флакона
Eldritch Battery during Effect->Копия Удара души Колчан точных стрел
Replica Soul Strike Spike-Point Arrow Quiver->Копия Сборщика душ Осадный топор
Replica Soul Taker Siege Axe->Мистический накопитель
Eldritch Battery->Копия Оков души Матерчатый пояс
Replica Soul Tether Cloth Belt->Копия Бегства Калиги убийцы
Replica Stampede Assassin's Boots->Копия Знака Тасалио Кольцо с сапфиром
Replica Tasalio's Sign Sapphire Ring->Копия Буйной стали Воинский меч
Replica Tempestuous Steel War Sword->Копия Продуманного штурма Шагреневые ботинки
Replica Three-step Assault Shagreen Boots->Копия Трепанатора Большая колотушка
Replica Trypanon Great Mallet->Копия Твердыни Тукохамы Эбеновый ростовой щит
Replica Tukohama's Fortress Ebony Tower Shield->Магия крови
Blood Magic->Копия Падения Тул Опаловый жезл
Replica Tulfall Opal Wand->Копия Твизела Жезл провидца
Replica Twyzel Sage Wand->Копия Кинжала Ангила Засапожный нож
Replica Ungil's Gauche Boot Knife->Копия Нестабильного заряда Кобальтовый самоцвет
Replica Unstable Payload Cobalt Jewel->Копия Покрова ночи Большой шлем
Replica Veil of the Night Great Helmet->Копия Милосердия Виктарио Проклеенный каплевидный щит
Replica Victario's Charity Laminated Kite Shield->Копия Глаза пустоты Кольцо без камня
Replica Voideye Unset Ring->Копия Пустохода Сапоги смерти
Replica Voidwalker Murder Boots->Копия Провидения Волкуур Перчатки фанатика
Replica Volkuur's Guidance Zealot Gloves->Копия Рассекателя ветра Императорский лук
Replica Windripper Imperial Bow->Копия Крыльев энтропии Топор эзомита
Replica Wings of Entropy Ezomyte Axe->Копия Сердца зимы Золотой амулет
Replica Winterheart Gold Amulet->Копия Отвара ведьмовского огня Стибнитовый флакон










Blacksmith's Whetstone->Точильный камень
Scroll of Wisdom->Свиток мудрости
Chaos Orb->Сфера хаоса
Chaos Orbs->Сфер хаоса
Veiled Orb->Скрытая сфера
Armourer's Scrap->Деталь доспеха
Mirror of Kalandra->Зеркало Каландры
Orb of Alchemy->Сфера алхимии
Orbs of Alchemy->Сфер алхимии
Orb of Chance->Сфера удачи
Orbs of Chance->Сфер удачи
Orb of Regret->Сфера раскаяния
Orbs of Regret->Сфер раскаяния
Orb of Unmaking->Сфера небытия
Orbs of Unmaking->Сфер небытия
Orb of Transmutation->Сфера превращения
Orb of Alteration->Сфера перемен
Orbs of Transmutation->Сфер превращения
Orb of Scouring->Сфера очищения
Orbs of Scouring->Сфер очищения
Exalted Orb->Сфера возвышения
Exalted Orbs->Сфера возвышения
Regal Orb->Сфера царей
Orb of Augmentation->Сфера усиления
Portal Scroll->Свиток портала
Glassblower's Bauble->Стекольная масса
Gemcutter's Prism->Призма камнереза
Chromatic Orb->Цветная сфера
Orb of Fusing->Сфера соединения
Jeweller's Orb->Сфера златокузнеца
Divine Orb->Божественная сфера
Divine Orbs->Божественных сфер
Blessed Orb->Благодатная сфера
Sacred Orb->Священная сфера
Cartographer's Chisel->Резец картографа
Scroll Fragment->Обрывок свитка
Transmutation Shard->Осколок превращения
Alteration Shard->Осколок перемен
Alchemy Shard->Осколок алхимии
Albino Rhoa Feather->Перо белого роа
Eternal Orb->Сфера вечного
Imprint->Слепок
Vaal Orb->Сфера ваал
Enchant->Зачарование
Tainted Blessing->Порочное благословение
Corrupt->Осквернено
Perandus Coin->Монета Перандусов
Prophecy->Пророчество
Bestiary Orb->Сфера Бестиария
Imprinted Bestiary Orb->Запечатанная сфера Бестиария
Empty Coffin->Пустой гроб
Filled Coffin->Заполненный гроб
Surveyor's Compass->Компас топографа
Prime Regrading Lens->Первичная профилирующая линза
Secondary Regrading Lens->Вторичная профилирующая линза
Tempering Orb->Сфера закалки
Tailoring Orb->Сфера подгонки
Veiled Scarab->Скрытый скарабей
Apprentice Cartographer's Seal->Печать картоходца-ученика
Journeyman Cartographer's Seal->Печать картоходца-подмастерья
Master Cartographer's Seal->Печать мастера картоходца
Unshaping Orb->Сфера разрушения
Orb of Annulment->Сфера отмены
Orb of Binding->Сфера сплетения
Orb of Horizons->Сфера горизонтов
Harbinger's Orb->Сфера Предвестника
Engineer's Orb->Сфера инженера
Infused Engineer's Orb->Заряженная сфера инженера
Ancient Orb->Древняя сфера
Fracturing Orb->Раскалывающая сфера
Annulment Shard->Осколок отмены
Binding Shard->Осколок сплетения
Horizon Shard->Осколок горизонтов
Harbinger's Shard->Осколок Предвестника
Engineer's Shard->Инженерный осколок
Ancient Shard->Древний осколок
Chaos Shard->Осколок хаоса
Mirror Shard->Осколок зеркала
Exalted Shard->Осколок возвышения
Regal Shard->Осколок царей
Fracturing Shard->Раскалывающий осколок
Time-light Scroll->Свиток времени и света
Fragmentation Scroll->Свиток фрагментации
Deregulation Scroll->Свиток дерегуляции
Electroshock Scroll->Свиток электрошока
Haemocombustion Scroll->Свиток кровосожжения
Specularity Scroll->Свиток зеркальности
Facetor's Lens->Линза награнения
Magmatic Ore->Магматическая руда
Ritual Vessel->Ритуальный сосуд
Lesser Eldritch Ember->Мелкий древний уголёк
Greater Eldritch Ember->Крупный древний уголёк
Grand Eldritch Ember->Великий древний уголёк
Exceptional Eldritch Ember->Превосходный древний уголёк
Lesser Eldritch Ichor->Мелкий зловещий ихор
Greater Eldritch Ichor->Крупный зловещий ихор
Grand Eldritch Ichor->Великий зловещий ихор
Exceptional Eldritch Ichor->Превосходный зловещий ихор
Orb of Conflict->Сфера вражды
Uncarved Gemstone->Необработанный камень
Valdo's Puzzle Box->Куб загадок Валдо
Stacked Deck->Колода карт
Crusader's Exalted Orb->Сфера возвышения крестоносца
Redeemer's Exalted Orb->Сфера возвышения избавителя
Hunter's Exalted Orb->Сфера возвышения охотника
Warlord's Exalted Orb->Сфера возвышения вождя
Awakener's Orb->Сфера Пробудителя
Rogue's Marker->Разбойничий жетон
Orb of Dominance->Сфера господства
Enkindling Orb->Растопляющая сфера
Instilling Orb->Вливающая сфера
Exotic Coinage->Диковинные монеты
Scrap Metal->Металлолом
Astragali->Таранные кости
Burial Medallion->Погребальный медальон
Lesser Broken Circle Artifact->Мелкий артефакт Разомкнутого круга
Greater Broken Circle Artifact->Крупный артефакт Разомкнутого круга
Grand Broken Circle Artifact->Великий артефакт Разомкнутого круга
Exceptional Broken Circle Artifact->Превосходный артефакт Разомкнутого круга
Lesser Black Scythe Artifact->Мелкий артефакт Чёрной косы
Greater Black Scythe Artifact->Крупный артефакт Чёрной косы
Grand Black Scythe Artifact->Великий артефакт Чёрной косы
Exceptional Black Scythe Artifact->Превосходный артефакт Чёрной косы
Lesser Order Artifact->Мелкий артефакт Ордена
Greater Order Artifact->Крупный артефакт Ордена
Grand Order Artifact->Великий артефакт Ордена
Exceptional Order Artifact->Превосходный артефакт Ордена
Lesser Sun Artifact->Мелкий артефакт Солнца
Greater Sun Artifact->Крупный артефакт Солнца
Grand Sun Artifact->Великий артефакт Солнца
Exceptional Sun Artifact->Превосходный артефакт Солнца
Tainted Chromatic Orb->Порочная цветная сфера
Tainted Orb of Fusing->Порочная сфера соединения
Tainted Jeweller's Orb->Порочная сфера златокузнеца
Tainted Chaos Orb->Порочная сфера хаоса
Tainted Exalted Orb->Порочная сфера возвышения
Tainted Mythic Orb->Порочная мифическая сфера
Tainted Armourer's Scrap->Порочная деталь доспеха
Tainted Blacksmith's Whetstone->Порочный точильный камень
Tainted Divine Teardrop->Порочная божественная слеза
Eldritch Chaos Orb->Мистическая сфера хаоса
Eldritch Exalted Orb->Мистическая сфера возвышения
Eldritch Orb of Annulment->Мистическая сфера отмены
Singular Scouting Report->Необычный доклад разведки
Otherworldly Scouting Report->Потусторонний доклад разведки
Comprehensive Scouting Report->Подробный доклад разведки
Vaal Scouting Report->Осквернённый доклад разведки
Delirious Scouting Report->Бредовый доклад разведки
Operative's Scouting Report->Оперативный доклад разведки
Blighted Scouting Report->Заражённый доклад разведки
Influenced Scouting Report->Влиятельный доклад разведки
Explorer's Scouting Report->Исследовательский доклад разведки
Oil Extractor->Экстрактор масел
Power Core->Энергоядро
Transforming Power Core->Преобразующее энергоядро
Amplifying Power Core->Усиливающее энергоядро
Augmenting Power Core->Дополняющее энергоядро
Armour Recombinator->Рекомбинатор бронника
Weapon Recombinator->Рекомбинатор оружейника
Jewellery Recombinator->Рекомбинатор ювелира
Wild Crystallised Lifeforce->Дикая кристализованная жизненная сила
Vivid Crystallised Lifeforce->Буйная кристализованная жизненная сила
Primal Crystallised Lifeforce->Первобытная кристализованная жизненная сила
Sacred Crystallised Lifeforce->Священная кристализованная жизненная сила
Lycia's Invocation of Minion Instability->Воззвание Люции о Нестабильности приспешников
Lycia's Invocation of Resolute Technique->Воззвание Люции о Точных ударах
Lycia's Invocation of Blood Magic->Воззвание Люции о Магии крови
Lycia's Invocation of Pain Attunement->Воззвание Люции о Вдохновении болью
Lycia's Invocation of Elemental Equilibrium->Воззвание Люции о Равновесии стихий
Lycia's Invocation of Iron Grip->Воззвание Люции о Железной хватке
Lycia's Invocation of Point Blank->Воззвание Люции о Стрельбе в упор
Lycia's Invocation of Acrobatics->Воззвание Люции об Акробатике
Lycia's Invocation of Ghost Reaver->Воззвание Люции о Похитителе душ
Lycia's Invocation of Vaal Pact->Воззвание Люции о Соглашении с ваал
Lycia's Invocation of Elemental Overload->Воззвание Люции о Стихийной перегрузке
Lycia's Invocation of Avatar of Fire->Воззвание Люции о Воплощении огня
Lycia's Invocation of Eldritch Battery->Воззвание Люции о Мистическом накопителе
Lycia's Invocation of Ancestral Bond->Воззвание Люции о Связи с предками
Lycia's Invocation of Crimson Dance->Воззвание Люции о Багровом танце
Lycia's Invocation of Perfect Agony->Воззвание Люции о Совершенной агонии
Lycia's Invocation of Runebinder->Воззвание Люции о Рунической вязи
Lycia's Invocation of Glancing Blows->Воззвание Люции о Скользящих ударах
Lycia's Invocation of Call to Arms->Воззвание Люции о Призыве к оружию
Lycia's Invocation of the Agnostic->Воззвание Люции об Агностике
Lycia's Invocation of Supreme Ego->Воззвание Люции о Величайшем эго
Lycia's Invocation of the Impaler->Воззвание Люции о Пронзателе
Lycia's Invocation of Hex Master->Воззвание Люции о Чародее
Lycia's Invocation of Lethe Shade->Воззвание Люции о Тени смерти
Lycia's Invocation of Ghost Dance->Воззвание Люции о Призрачном танце
Lycia's Invocation of Versatile Combatant->Воззвание Люции об Универсальном бойце
Lycia's Invocation of Magebane->Воззвание Люции о Погибели магов
Lycia's Invocation of Solipsism->Воззвание Люции о Солипсизме
Lycia's Invocation of Divine Shield->Воззвание Люции о Божественном щите
Lycia's Invocation of Iron Will->Воззвание Люции о Железной воле
Lycia's Invocation of Wicked Ward->Воззвание Люции о Нечестивом страже
Lycia's Invocation of Wind Dancer->Воззвание Люции о Танцующем с ветром
Lycia's Invocation of Conduit->Воззвание Люции о Проводнике
Lycia's Invocation of Arrow Dancing->Воззвание Люции о Танце со стрелами
Lycia's Invocation of Precise Technique->Воззвание Люции о Безупречном приёме
Lycia's Invocation of Iron Reflexes->Воззвание Люции о Стальных нервах
Lycia's Invocation of Unwavering Stance->Воззвание Люции о Несокрушимости
Lycia's Invocation of Imbalanced Guard->Воззвание Люции о Несбалансированной защите
Lycia's Invocation of Eternal Youth->Воззвание Люции о Вечной молодости
Lycia's Invocation of Mind over Matter->Воззвание Люции о Разуме превыше материи
Lycia's Invocation of Zealot's Oath->Воззвание Люции об Обете фанатика
Gold->Золото
Igneous Geode->Огненная жеода
Crystalline Geode->Кристаллическая жеода
Silver Coin->Серебряная монета
Hinekora's Lock->Прядь Хинекоры
Omen of Amelioration->Предсказание избавления
Omen of Return->Предсказание возвращения
Omen of Death-dancing->Предсказание танца со смертью
Omen of Refreshment->Предсказание восполнения
Omen of the Soul Devourer->Предсказание Пожирателя душ
Omen of Acceleration->Предсказание ускорения
Omen of Fortune->Предсказание удачи
Omen of the Jeweller->Предсказание златокузнеца
Omen of Connections->Предсказание связей
Omen of Blanching->Предсказание обеления
Omen of Revenge->Предсказание мести
Omen of Bequeathal->Предсказание наследства
Omen of Resurgence->Предсказание возрождения
Omen of Adrenaline->Предсказание адреналина
Omen of Death's Door->Предсказание Врат Смерти
Omen of Brilliance->Предсказание великолепия
Tattoo of the Ngamahu Firewalker->Татуировка Огненного ходока Нгамаху
Tattoo of the Ngamahu Shaman->Татуировка Шамана Нгамаху
Tattoo of the Ngamahu Warrior->Татуировка Воина Нгамаху
Tattoo of the Ngamahu Warmonger->Татуировка Зачинщика войны Нгамаху
Tattoo of the Ngamahu Woodcarver->Татуировка Резчика по дереву Нгамаху
Loyalty Tattoo of Kaom->Татуировка верности Каому
Tattoo of the Ngamahu Makanga->Татуировка Маканги Нгамаху
Tattoo of the Kitava Blood Drinker->Татуировка Кровопийцы Китавы
Tattoo of the Kitava Rebel->Татуировка Смутьяна Китавы
Tattoo of the Kitava Warrior->Татуировка Воина Китавы
Tattoo of the Kitava Heart Eater->Татуировка Пожирателя сердец Китавы
Tattoo of the Kitava Shaman->Татуировка Шамана Китавы
Loyalty Tattoo of Utula->Татуировка верности Утуле
Tattoo of the Kitava Makanga->Татуировка Маканги Китавы
Tattoo of the Tukohama Shaman->Татуировка Шамана Тукохамы
Tattoo of the Tukohama Warrior->Татуировка Воина Тукохамы
Tattoo of the Tukohama Brawler->Татуировка Поединщика Тукохамы
Tattoo of the Tukohama Warmonger->Татуировка Зачинщика войны Тукохамы
Tattoo of the Tukohama Warcaller->Татуировка Глашатая войны Тукохамы
Loyalty Tattoo of Akoya->Татуировка верности Акойе
Tattoo of the Tukohama Makanga->Татуировка Маканги Тукохамы
Tattoo of the Rongokurai Warrior->Татуировка Воина Ронгокураи
Tattoo of the Rongokurai Brute->Татуировка Громилы Ронгокураи
Tattoo of the Rongokurai Goliath->Татуировка Голиафа Ронгокураи
Tattoo of the Rongokurai Turtle->Татуировка Черепахи Ронгокураи
Tattoo of the Rongokurai Guard->Татуировка Стражника Ронгокураи
Loyalty Tattoo of Kahuturoa->Татуировка верности Кахутуруа
Tattoo of the Rongokurai Makanga->Татуировка Маканги Ронгокураи
Tattoo of the Tasalio Bladedancer->Татуировка Танцующего с клинками Тасалио
Tattoo of the Tasalio Tideshifter->Татуировка Волнореза Тасалио
Tattoo of the Tasalio Shaman->Татуировка Шамана Тасалио
Tattoo of the Tasalio Warrior->Татуировка Воина Тасалио
Tattoo of the Tasalio Scout->Татуировка Разведчика Тасалио
Loyalty Tattoo of Rakiata->Татуировка верности Ракиате
Tattoo of the Tasalio Makanga->Татуировка Маканги Тасалио
Tattoo of the Arohongui Moonwarden->Татуировка Хранителя луны Арохонгуи
Tattoo of the Arohongui Scout->Татуировка Разведчика Арохонгуи
Tattoo of the Arohongui Warrior->Татуировка Воина Арохонгуи
Tattoo of the Arohongui Warmonger->Татуировка Зачинщика войны Арохонгуи
Tattoo of the Arohongui Shaman->Татуировка Шамана Арохонгуи
Loyalty Tattoo of Ikiaho->Татуировка верности Икиао
Tattoo of the Arohongui Makanga->Татуировка Маканги Арохонгуи
Tattoo of the Ramako Scout->Татуировка Разведчика Рамако
Tattoo of the Ramako Archer->Татуировка Лучника Рамако
Tattoo of the Ramako Sniper->Татуировка Снайпера Рамако
Tattoo of the Ramako Fleetfoot->Татуировка Гонца Рамако
Tattoo of the Ramako Shaman->Татуировка Шамана Рамако
Loyalty Tattoo of Ahuana->Татуировка верности Ахване
Tattoo of the Ramako Makanga->Татуировка Маканги Рамако
Tattoo of the Hinekora Warrior->Татуировка Воина Хинекоры
Tattoo of the Hinekora Deathwarden->Татуировка Стража смерти Хинекоры
Tattoo of the Hinekora Shaman->Татуировка Шамана Хинекоры
Tattoo of the Hinekora Storyteller->Татуировка Сказителя Хинекоры
Tattoo of the Hinekora Warmonger->Татуировка Зачинщика войны Хинекоры
Loyalty Tattoo of Tawhanuku->Татуировка верности Тавануку
Tattoo of the Hinekora Makanga->Татуировка Маканги Хинекоры
Tattoo of the Tawhoa Naturalist->Татуировка Натуралиста Тахоа
Tattoo of the Tawhoa Scout->Татуировка Разведчика Тахоа
Tattoo of the Tawhoa Warrior->Татуировка Воина Тахоа
Tattoo of the Tawhoa Herbalist->Татуировка Травника Тахоа
Tattoo of the Tawhoa Shaman->Татуировка Шамана Тахоа
Loyalty Tattoo of Maata->Татуировка верности Маате
Tattoo of the Tawhoa Makanga->Татуировка Маканги Тахоа
Tattoo of the Valako Stormrider->Татуировка Наездника бури Валако
Tattoo of the Valako Scout->Татуировка Разведчика Валако
Tattoo of the Valako Warrior->Татуировка Воина Валако
Tattoo of the Valako Shieldbearer->Татуировка Щитоносца Валако
Tattoo of the Valako Shaman->Татуировка Шамана Валако
Loyalty Tattoo of Kiloava->Татуировка верности Килоаве
Tattoo of the Valako Makanga->Татуировка Маканги Валако
Honoured Tattoo of the Dove->Почётная татуировка голубя
Honoured Tattoo of the Sky->Почётная татуировка неба
Honoured Tattoo of the Tuatara->Почётная татуировка туатары
Honoured Tattoo of the Pillager->Почётная татуировка грабителя
Honoured Tattoo of the Turtle->Почётная татуировка черепахи
Honoured Tattoo of the Oak->Почётная татуировка дуба
Honoured Tattoo of the Hatungo->Почётная татуировка хатанго
Honoured Tattoo of the Flock->Почётная татуировка стаи
Honoured Tattoo of the Warlord->Почётная татуировка военачальника
Honoured Tattoo of the Mountain->Почётная татуировка горы
Honoured Tattoo of the Pa->Почётная татуировка Па
Honoured Tattoo of the Hunter->Почётная татуировка охотника
Honoured Tattoo of the Barbarian->Почётная татуировка варвара
Honoured Tattoo of the Berserker->Почётная татуировка берсерка
Honoured Tattoo of the Wise->Почётная татуировка мудреца
Honoured Tattoo of the Storm->Почётная татуировка бури
Honoured Tattoo of the Flood->Почётная татуировка потопа
Ancestral Tattoo of Bloodlines->Татуировка кровных уз предков
Honoured Tattoo of the Makanga->Почётная татуировка маканги
Journey Tattoo of the Body->Татуировка странствия тела
Journey Tattoo of the Mind->Татуировка странствия разума
Journey Tattoo of the Soul->Татуировка странствия души
Journey Tattoo of Makanui->Татуировка странствия Макануи



Vivid Wisps->Буйные огоньки
Wild Wisps->Дикие огоньки
Primal Wisps->Первобытные огоньки
All Unique->Все Уникальный
All Gem->Все Камень
One Handed Weapons->Одноручное оружие
Claws->Когти
Daggers->Кинжалы
Wands->Жезлы
One Hand Swords->Одноручные мечи
Thrusting One Hand Swords->Шпаги
One Hand Axes->Одноручные топоры
One Hand Maces->Одноручные булавы
Sceptres->Скипетры
Rune Daggers->Рунические кинжалы
Two Handed Weapons->Двуручное оружие
Bows->Луки
Staves->Посохи
Two Hand Swords->Двуручные мечи
Two Hand Axes->Двуручные топоры
Two Hand Maces->Двуручные булавы
Warstaves->Воинские посохи
Fishing Rods->Удочки
Off-hand->Для левой руки
Quivers->Колчаны
Shields->Щиты
Armour->Доспехи
Gloves->Перчатки
Boots->Обувь
Body Armours->Доспехи
Helmets->Шлемы
Jewellery->Бижутерия
Amulets->Амулеты
Rings->Кольца
Belts->Пояса
Trinkets->Украшения
Jewels->Самоцветы
Jewels->Самоцветы
Abyss Jewels->Самоцветы Бездны
Cluster Jewel->Кластерный самоцвет
Timeless Jewel->Вневременной самоцвет
Flasks->Флаконы
Flasks->Флаконы
Life Flasks->Флаконы жизни
Mana Flasks->Флаконы маны
Hybrid Flasks->Флаконы равновесия
Utility Flasks->Особые флаконы
Other->Другое
Strongbox->Ларец
League Specific->League Specific
Replica->Replica
Hideouts->Убежища
Resonator->Резонатор
Expedition Logbook->Журнал экспедиции
Hideout Doodads->Предметы убежища
Divination Cards->Гадальные карты
Pieces->Фрагменты
Incubators->Инкубаторы
Tinctures->Микстуры
Corpses->Трупы
Charms->Обереги
Embers of the Allflame->Уголья Всепламени
Maps->Карты
Maps->Карты
Map Fragments->Обрывки карт
Misc Map Items->Прочие предметы карт
Memories->Воспоминания
Scarab->Скарабей
Breachstone->Камень Разлома
Emblem->Emblem
Lure->Lure
Delirium Orb->Сфера Делириума
Gems->Камни
Skill Gems->Камни умений
Support Gems->Камни поддержки
Currency->Валюта
Stackable Currency->Валюта
Oil->Масло
Fossil->Ископаемое
Catalysts->Катализаторы
Essence->Сущность
Vial->Ваал
Splinter->Splinter
Blessing->Благословение
Heist->Кража
Contracts->Контракты
Blueprints->Чертежи
Heist Gear->Разбойничьи принадлежности
Heist Tools->Разбойничий инструмент
Heist Cloaks->Разбойничьи накидки
Heist Brooches->Разбойничьи броши
Heist Targets->Предметы кражи
Experimented->Экспериментальный
Unusual Gems->Необычные камни 

		
Empower Support->Усилитель
Chance to Bleed Support->Шанс кровотечения
Ruthless Support->Беспощадность
Ancestral Call Support->Зов предков
Added Fire Damage Support->Урон огнём
Earthbreaker Support->Камнелом
Flamewood Support->Лучина
Knockback Support->Отбрасывание
Life Gain on Hit Support->Здоровье за удар
Lifetap Support->Жизнеотвод
Maim Support->Увечье
Melee Splash Support->Раскатистый удар
Ballista Totem Support->Тотем-баллиста
Spell Totem Support->Колдующий тотем
Stun Support->Оглушение
Bloodlust Support->Кровожадность
Cold to Fire Support->Холод в огонь
Cruelty Support->Злость
Endurance Charge on Melee Stun Support->Заряд выносливости при оглушении в ближнем бою
Iron Grip Support->Железная хватка
Iron Will Support->Железная воля
Damage on Full Life Support->Урон при полном здоровье
Melee Physical Damage Support->Физический урон ближнего боя
Rage Support->Свирепость
Shockwave Support->Ударная волна
Volatility Support->Нестабильность
Elemental Damage with Attacks Support->Урон от стихий атаками
Arrogance Support->Заносчивость
Bloodthirst Support->Кровавое зверство
Controlled Blaze Support->Управляемое горение
Corrupting Cry Support->Оскверняющий клич
Divine Blessing Support->Божественное благословение
Fire Penetration Support->Пронизывающий жар
Fortify Support->Укрепление
Generosity Support->Щедрость
Guardian's Blessing Support->Благословение защитника
Burning Damage Support->Урон от горения
Increased Duration Support->Продление
Life Leech Support->Вытягивание здоровья
Pulverise Support->Распыление
Less Duration Support->Сокращение
Inspiration Support->Вдохновение
Urgent Orders Support->Срочные приказы
Behead Support->Обезглавливание
Brutality Support->Жестокость
Cast when Damage Taken Support->Сотворение чар при получении урона
Cast on Melee Kill Support->Сотворение чар при убийстве в ближнем бою
Eternal Blessing Support->Вечное благословение
Fist of War Support->Кулак войны
Multiple Totems Support->Множество тотемов
Multistrike Support->Град ударов
Trauma Support->Травма
Awakened Added Fire Damage Support->Пробужденный: Урон огнем
Awakened Ancestral Call Support->Пробужденный: Зов предков
Awakened Brutality Support->Пробужденный: Жестокость
Awakened Burning Damage Support->Пробужденный: Урон от горения
Awakened Empower Support->Пробуждённый: Усилитель
Awakened Fire Penetration Support->Пробужденный: Пронизывающий жар
Awakened Generosity Support->Пробужденный: Щедрость
Awakened Melee Physical Damage Support->Пробужденный: Физический урон ближнего боя
Awakened Melee Splash Support->Пробужденный: Раскатистый удар
Awakened Multistrike Support->Пробужденный: Град ударов
Awakened Elemental Damage with Attacks Support->Пробужденный: Урон от стихий атаками
Enhance Support->Улучшитель
Chance to Poison Support->Шанс отравить
Momentum Support->Импульс
Mirage Archer Support->Призрачный лучник
Volley Support->Залп
Pierce Support->Пронзание
Swift Assembly Support->Быстрая сборка
Added Cold Damage Support->Урон холодом
Additional Accuracy Support->Меткость
Arrow Nova Support->Кольцо стрел
Blind Support->Ослепление
Chance to Flee Support->Паника
Faster Attacks Support->Ускорение атак
Lesser Multiple Projectiles Support->Дополнительные снаряды
Locus Mine Support->Направленная мина
Manaforged Arrows Support->Стрелы маны
Multiple Traps Support->Дополнительные ловушки
Trap Support->Ловушка
Void Manipulation Support->Манипуляция пустотой
Block Chance Reduction Support->Затруднение блока
Close Combat Support->Бой вплотную
Culling Strike Support->Добивание
Deadly Ailments Support->Смертельные состояния
Nightblade Support->Клинок во тьме
Vicious Projectiles Support->Яростные снаряды
Point Blank Support->Стрельба в упор
Sadism Support->Садизм
Trap and Mine Damage Support->Урон ловушек и мин
Cold Penetration Support->Пронизывающий холод
Hypothermia Support->Переохлаждение
Faster Projectiles Support->Ускорение снарядов
Focused Ballista Support->Прицельная баллиста
Fork Support->Разветвление
Ice Bite Support->Укус льда
Charged Traps Support->Заряженные ловушки
Impale Support->Прокол
Mana Leech Support->Вытягивание маны
Critical Strike Affliction Support->Критические удары состояниями
Swift Affliction Support->Стремительный недуг
Second Wind Support->Второе дыхание
Slower Projectiles Support->Замедленные снаряды
Advanced Traps Support->Улучшенные ловушки
Barrage Support->Стрельба очередями
Cast On Critical Strike Support->Сотворение чар при критическом ударе
Cast on Death Support->Сотворение чар при смерти
Chain Support->Цепь
Withering Touch Support->Губительное прикосновение
Cluster Traps Support->Кассетные ловушки
Greater Multiple Projectiles Support->Много дополнительных снарядов
Greater Volley Support->Большой залп
Mark On Hit Support->Метка при попадании
Returning Projectiles Support->Возвращающиеся снаряды
Vile Toxins Support->Едкие токсины
Awakened Added Cold Damage Support->Пробужденный: Урон холодом
Awakened Arrow Nova Support->Пробужденный: Кольцо стрел
Awakened Cast On Critical Strike Support->Пробужденный: Сотворение чар при критическом ударе
Awakened Chain Support->Пробужденный: Цепь
Awakened Cold Penetration Support->Пробужденный: Пронизывающий холод
Awakened Deadly Ailments Support->Пробужденный: Смертельные состояния
Awakened Enhance Support->Пробуждённый: Улучшитель
Awakened Fork Support->Пробужденный: Разветвление
Awakened Greater Multiple Projectiles Support->Пробужденный: Много дополнительных снарядов
Awakened Swift Affliction Support->Пробужденный: Стремительный недуг
Awakened Vicious Projectiles Support->Пробужденный: Яростные снаряды
Awakened Void Manipulation Support->Пробужденный: Манипуляция пустотой
Enlighten Support->Наставник
Arcane Surge Support->Колдовской выброс
Elemental Proliferation Support->Разгул стихий
Prismatic Burst Support->Радужная вспышка
Spell Cascade Support->Каскад чар
Infused Channelling Support->Усиленное поддержание
Summon Phantasm Support->Призыв фантома
Added Lightning Damage Support->Урон молнией
Combustion Support->Воспламенение
Devour Support->Пожирание
Efficacy Support->Эффективность
Increased Critical Strikes Support->Учащение критических ударов
Infernal Legion Support->Пылающий легион
Minion Damage Support->Урон приспешников
Blastchain Mine Support->Цепной подрыв
Unbound Ailments Support->Безграничные состояния
Concentrated Effect Support->Средоточие
Controlled Destruction Support->Контролируемое разрушение
Predator Support->Хищник
Elemental Focus Support->Концентрация стихий
Faster Casting Support->Ускоренное сотворение чар
Fresh Meat Support->Свежее мясо
Increased Critical Damage Support->Усиление критических ударов
Minion Life Support->Здоровье приспешников
Minion Speed Support->Скорость приспешников
Overcharge Support->Перегрузка
Physical to Lightning Support->Физический урон в молнии
Power Charge On Critical Support->Заряд энергии при критическом ударе
Sacred Wisps Support->Священные огоньки
Trinity Support->Триединство
Added Chaos Damage Support->Урон хаосом
Archmage Support->Архимаг
Blasphemy Support->Богохульство
Charged Mines Support->Заряженные мины
Cursed Ground Support->Проклятая земля
Elemental Penetration Support->Пронизывающие стихии
Energy Leech Support->Похищение энергетического щита
Feeding Frenzy Support->Голодное остервенение
Intensify Support->Интенсивность
High-Impact Mine Support->Усиленная мина
Impending Doom Support->Обречённость
Item Rarity Support->Редкость предметов
Lightning Penetration Support->Пронизывающие молнии
Meat Shield Support->Живой щит
Innervate Support->Возбуждение
Pinpoint Support->Сосредоточение
Sacrifice Support->Жертвоприношение
Elemental Army Support->Стихийное войско
Swiftbrand Support->Быстрое клеймение
Bonechill Support->Леденящее охлаждение
Cast when Stunned Support->Сотворение чар при оглушении
Cast while Channelling Support->Сотворение чар при поддержании
Hextouch Support->Касание порчи
Decay Support->Разложение
Frigid Bond Support->Морозные узы
Unleash Support->Высвобождение
Hex Bloom Support->Расцвет порчи
Ignite Proliferation Support->Распространение поджога
Immolate Support->Жертвенность
Increased Area of Effect Support->Расширенная область действия
Minefield Support->Минное поле
Spell Echo Support->Эхо магии
Spellblade Support->Чародейский клинок
Awakened Added Chaos Damage Support->Пробужденный: Урон хаосом
Awakened Added Lightning Damage Support->Пробужденный: Урон молнией
Awakened Blasphemy Support->Пробужденный: Богохульство
Awakened Cast While Channelling Support->Пробужденный: Сотворение чар при поддержании
Awakened Controlled Destruction Support->Пробужденный: Контролируемое разрушение
Awakened Hextouch Support->Пробужденный: Касание порчи
Awakened Elemental Focus Support->Пробужденный: Концентрация стихий
Awakened Enlighten Support->Пробуждённый: Наставник
Awakened Increased Area of Effect Support->Пробужденный: Расширенная область действия
Awakened Lightning Penetration Support->Пробужденный: Пронизывающие молнии
Awakened Minion Damage Support->Пробужденный: Урон приспешников
Awakened Spell Cascade Support->Пробужденный: Каскад чар
Awakened Spell Echo Support->Пробужденный: Эхо магии
Awakened Unbound Ailments Support->Пробужденный: Безграничные состояния
Awakened Unleash Support->Пробужденный: Высвобождение
Call to Arms->Призыв к оружию
Ice Shot of Penetration->Ледяной выстрел пронзания
Elemental Hit of the Spectrum->Спектральный удар стихии
Poisonous Concoction of Bouncing->Отскакивающая ядовитая смесь
Artillery Ballista of Cross Strafe->Артиллерийская баллиста перекрестного огня
Artillery Ballista of Focus Fire->Артиллерийская баллиста прицельного огня
Tornado of Elemental Turbulence->Торнадо стихийной хаотичности
Summon Holy Relic of Conviction->Призыв священной реликвии убеждения
Incinerate of Expanse->Массивное испепеление
Incinerate of Venting->Испепеление выброса
Sacred Wisps Support->Священные огоньки
Automation->Автоматизация
Kinetic Blast of Clustering->Кинетический взрыв скопления

Call to Arms->Призыв к оружию
Ice Shot of Penetration->Ледяной выстрел пронзания
Elemental Hit of the Spectrum->Спектральный удар стихии
Poisonous Concoction of Bouncing->Отскакивающая ядовитая смесь
Artillery Ballista of Cross Strafe->Артиллерийская баллиста перекрестного огня
Artillery Ballista of Focus Fire->Артиллерийская баллиста прицельного огня
Tornado of Elemental Turbulence->Торнадо стихийной хаотичности
Summon Holy Relic of Conviction->Призыв священной реликвии убеждения
Incinerate of Expanse->Массивное испепеление
Incinerate of Venting->Испепеление выброса
Sacred Wisps Support->Священные огоньки
Automation->Автоматизация
Kinetic Blast of Clustering->Кинетический взрыв скопления
		
		
		
		
		
		
		
		

//////////////////////////////// Скарабеи //////////////////////////////////
Scarabs->Скарабеи
Abyss Scarab->Скарабей Бездны
Abyss Scarab of Edifice->Скарабей Бездны строений
Abyss Scarab of Emptiness->Скарабей Бездны пустоты
Abyss Scarab of Multitudes->Скарабей Бездны множеств
Abyss Scarab of Profound Depth->Скарабей Засады
Ambush Scarab->Скарабей Засады содержания
Ambush Scarab of Containment->Скарабей Засады разборчивости
Ambush Scarab of Discernment->Скарабей Засады потайных отсеков
Ambush Scarab of Hidden Compartments->Скарабей Засады могущества
Ambush Scarab of Potency->Скарабей Анархии
Anarchy Scarab->Скарабей Анархии исполинства
Anarchy Scarab of Gigantification->Скарабей Анархии партнёрства
Anarchy Scarab of Partnership->Скарабей Бестиария
Bestiary Scarab->Скарабей Бестиария удвоения
Bestiary Scarab of Duplicating->Скарабей Бестиария стаи
Bestiary Scarab of the Herd->Скарабей Бестиария тёмной вороны
Bestiary Scarab of the Shadowed Crow->Скарабей Предательства
Betrayal Scarab->Скарабей Предательства разведки
Betrayal Scarab of Intelligence->Скарабей Предательства увековечения
Betrayal Scarab of Perpetuation->Скарабей Предательства подкреплений
Betrayal Scarab of Reinforcements->Скарабей Иномирья
Beyond Scarab->Скарабей Иномирья осквернения
Beyond Scarab of Corruption->Скарабей Иномирья кровопотери
Beyond Scarab of Haemophilia->Скарабей Иномирья возрождения
Beyond Scarab of Resurgence->Скарабей Иномирья вторжения
Beyond Scarab of the Invasion->Скарабей Скверны
Blight Scarab->Скарабей Скверны цветения
Blight Scarab of Blooming->Скарабей Скверны щедрости
Blight Scarab of Bounty->Скарабей Скверны масел
Blight Scarab of Invigoration->Скарабей Разлома
Blight Scarab of Oils->Скарабей Разлома владений
Breach Scarab->Скарабей Разлома ловушек
Breach Scarab of Lordship->Скарабей Разлома расщепления
Breach Scarab of Resonant Cascade->Скарабей Разлома мечтателя
Breach Scarab of Snares->Скарабей картографии
Breach Scarab of Splintering->Скарабей картографии восхождения
Breach Scarab of the Dreamer->Скарабей картографии осквернения
Cartography Scarab->Скарабей картографии удвоения
Cartography Scarab of Ascension->Скарабей картографии неповторимости
Cartography Scarab of Corruption->Скарабей Делириума
Cartography Scarab of Duplication->Скарабей Делириума галлюцинаций
Cartography Scarab of Singularity->Скарабей Делириума мании
Delirium Scarab->Скарабей Делириума неврозов
Delirium Scarab of Delusions->Скарабей Делириума паранойи
Delirium Scarab of Mania->Скарабей предсказания
Delirium Scarab of Neuroses->Скарабей предсказания завершения
Delirium Scarab of Paranoia->Скарабей предсказания курирования
Divination Scarab->Скарабей Господства
Divination Scarab of Completion->Скарабей Господства аномалии
Divination Scarab of Curation->Скарабей Господства учений
Domination Scarab->Скарабей Господства ужасов
Domination Scarab of Abnormality->Скарабей Сущности
Domination Scarab of Teachings->Скарабей Сущности восхождения
Domination Scarab of Terrors->Скарабей Сущности окостенения
Essence Scarab->Скарабей Сущности стабильности
Essence Scarab of Adaptation->Скарабей Экспедиции
Essence Scarab of Ascent->Скарабей Экспедиции археологии
Essence Scarab of Calcification->Скарабей Экспедиции поиска рун
Essence Scarab of Stability->Скарабей Экспедиции скальда
Expedition Scarab->Скарабей Экспедиции веризиевой пыли
Expedition Scarab of Archaeology->Скарабей Предвестника
Expedition Scarab of Runefinding->Скарабей Предвестника разборчивости
Expedition Scarab of the Skald->Скарабей Предвестника регентства
Expedition Scarab of Verisium Powder->Скарабей Предвестника военных запасов
Harbinger Scarab->Скарабей Жатвы
Harbinger Scarab of Discernment->Скарабей Жатвы изобилия
Harbinger Scarab of Regency->Скарабей Жатвы удвоения
Harbinger Scarab of Warhoards->Рогатый скарабей пробуждения
Harvest Scarab->Рогатый скарабей Родословных
Harvest Scarab of Cornucopia->Рогатый скарабей переливов
Harvest Scarab of Doubling->Рогатый скарабей Немезиды
Horned Scarab of Awakening->Рогатый скарабей Пандемониума
Horned Scarab of Bloodlines->Рогатый скарабей сохранения
Horned Scarab of Glittering->Рогатый скарабей традиций
Horned Scarab of Nemeses->Скарабей Вмешательства
Horned Scarab of Pandemonium->Скарабей Вмешательства чемпионов
Horned Scarab of Preservation->Скарабей Вмешательства вторжения
Horned Scarab of Tradition->Скарабей Вмешательства хроник
Incursion Scarab->Влиятельный скарабей превращения
Incursion Scarab of Champions->Влиятельный скарабей орд
Incursion Scarab of Invasion->Влиятельный скарабей Древнего
Incursion Scarab of Timelines->Влиятельный скарабей Создателя
Influencing Scarab of Conversion->Скарабей Легиона
Influencing Scarab of Hordes->Скарабей Легиона командования
Influencing Scarab of the Elder->Скарабей Легиона вечной войны
Influencing Scarab of the Shaper->Скарабей Легиона офицеров
Legion Scarab->Скарабей Легиона Сехемы
Legion Scarab of Command->Загадочный скарабей
Legion Scarab of Eternal Conflict->Реликтовый скарабей
Legion Scarab of Officers->Реликтовый скарабей повелителей
Legion Scarab of The Sekhema->Реликтовый скарабей видения
Mysterious Scarab->Ритуальный скарабей изобилия
Reliquary Scarab->Ритуальный скарабей признания
Reliquary Scarab of Overlords->Ритуальный скарабей избранности
Reliquary Scarab of Vision->Скарабей антагонистов
Ritual Scarab of Abundance->Скарабей затравленных предателей
Ritual Scarab of Recognition->Скарабей чудовищных поколений
Ritual Scarab of Selectiveness->Скарабей стабильности
Scarab of Adversaries->Сульфитовый скарабей
Scarab of Hunted Traitors->Сульфитовый скарабей испарений
Scarab of Monstrous Lineage->Сульфитовый скарабей алчности
Scarab of Radiant Storms->Скарабей Мучения
Scarab of Stability->Скарабей Мучения своеобразия
Scarab of Wisps->Скарабей Мучения освобождения
Sulphite Scarab->Скарабей Ультиматума
Sulphite Scarab of Fumes->Скарабей Ультиматума подкупа
Sulphite Scarab of Greed->Скарабей Ультиматума катализа
Torment Scarab->Скарабей Ультиматума поединка
Torment Scarab of Peculiarity->Скарабей Ультиматума начертания
Torment Scarab of Possession->Скрытый скарабей
Torment Scarab of Release->Скарабей создания
Ultimatum Scarab->Скарабей тени
Ultimatum Scarab of Bribing->Скарабей покровительства
Ultimatum Scarab of Catalysing->Скарабей зла
Ultimatum Scarab of Dueling->Скарабей ярости
Ultimatum Scarab of Inscription->Скарабей безумия
Veiled Scarab->Скарабей архетипов





//////////////////////////////// Камни умений //////////////////////////////////
Skill Gems->Камни умений
Cleave->Рассечение
Cleave of Rage->Рассечение свирепости
Glacial Hammer->Леденящий молот
Glacial Hammer of Shattering->Леденящий молот разбивания
Ground Slam->Сотрясение
Ground Slam of Earthshaking->Сотрясение земли
Heavy Strike->Тяжёлый удар
Molten Strike->Магмовый удар
Molten Strike of the Zenith->Магмовый удар зенита
Perforate->Пронзающие шипы
Perforate of Duality->Пронзающие шипы двойственности
Perforate of Bloodshed->Пронзающие шипы резни
Shield Crush->Сокрушающий щит
Shield Crush of the Chieftain->Сокрушающий щит вождя
Smite->Кара
Smite of Divine Judgement->Кара божественного правосудия
Vaal Cleave->Рассечение ваал
Vaal Glacial Hammer->Леденящий молот ваал
Vaal Ground Slam->Сотрясение ваал
Vaal Molten Strike->Магмовый удар ваал
Vaal Smite->Кара ваал
Blood and Sand->Кровь и песок
Decoy Totem->Тотем-приманка
Devouring Totem->Поглощающий тотем
Holy Flame Totem->Тотем священного огня
Holy Flame Totem of Ire->Гневный тотем священного огня
Ancestral Protector->Защитник предков
Molten Shell->Расплавленный панцирь
Reckoning->Возмездие
Rejuvenation Totem->Восполняющий тотем
Steelskin->Стальная кожа
Vaal Molten Shell->Расплавленный панцирь ваал
Vaal Rejuvenation Totem->Восполняющий тотем ваал
Vigilant Strike->Расчётливый удар
War Banner->Знамя войны
Enduring Cry->Клич стойкости
Intimidating Cry->Устрашающий клич
Leap Slam->Наскок
Leap Slam of Groundbreaking->Наскок сотрясения
Shield Charge->Удар щитом
Vitality->Живучесть
Absolution->Отпущение
Absolution of Inspiring->Отпущение вдохновения
Chain Hook->Цепной крюк
Earthshatter->Разлом земли
Earthshatter of Fragility->Разлом земли хрупкости
Earthshatter of Prominence->Разлом земли влияния
Exsanguinate->Обескровливание
Exsanguinate of Transmission->Заражающее обескровливание
Infernal Blow->Удар преисподней
Infernal Blow of Immolation->Удар преисподней самосожжения
Searing Bond->Обжигающие узы
Static Strike->Статичный разряд
Sunder->Раскол
Sunder of Earthbreaking->Сокрушающий раскол
Sweep->Круговой взмах
Vaal Absolution->Отпущение ваал
Vaal Volcanic Fissure->Вулканический разлом ваал
Volcanic Fissure->Вулканический разлом
Volcanic Fissure of Snaking->Вулканический разлом зигзагов
Ancestral Cry->Клич предков
Corrupting Fever->Разлагающая лихорадка
Defiance Banner->Знамя непокорности
Flesh and Stone->Камень и плоть
Herald of Ash->Вестник пепла
Herald of Purity->Вестник чистоты
Seismic Cry->Сейсмический клич
Warlord's Mark->Метка вождя
Infernal Cry->Клич преисподней
Anger->Жгучая злоба
Battlemage's Cry->Клич боевого мага
Call to Arms->Призыв к оружию
Determination->Решимость
Dread Banner->Знамя страха
Purity of Fire->Спасение от огня
General's Cry->Клич полководца
Vulnerability->Беззащитность
Petrified Blood->Окаменелая кровь
Pride->Гордость
Punishment->Наказание
Rallying Cry->Клич сплочения
Vaal Impurity of Fire->Погибель от огня ваал
Vengeance->Отмщение
Ancestral Warchief->Вождь предков
Animate Guardian->Аниматрон
Animate Guardian of Smiting->Аниматрон кары
Bladestorm->Ураган лезвий
Bladestorm of Uncertainty->Ураган лезвий неопределённости
Reap->Кровавая жатва
Boneshatter->Дробление костей
Boneshatter of Complex Trauma->Дробление костей сложного перелома
Boneshatter of Carnage->Дробление костей бойни
Consecrated Path->Освящённый путь
Consecrated Path of Endurance->Освящённый путь выносливости
Dominating Blow->Удар власти
Dominating Blow of Inspiring->Удар власти вдохновения
Earthquake->Землетрясение
Earthquake of Amplification->Землетрясение усиления
Ice Crash->Ледяное сокрушение
Ice Crash of Cadence->Ритмичное ледяное сокрушение
Rage Vortex->Свирепый вихрь
Rage Vortex of Berserking->Свирепый вихрь неистовства
Shockwave Totem->Сотрясающий тотем
Tectonic Slam->Тектонический удар
Tectonic Slam of Cataclysm->Тектонический удар катаклизма
Vaal Ancestral Warchief->Вождь предков ваал
Vaal Domination->Господство ваал
Vaal Earthquake->Землетрясение ваал
Vaal Reap->Кровавая жатва ваал
Berserk->Боевого безумие
Flame Link->Пламенная связь
Frozen Legion->Замёрзший легион
Frozen Legion of Rallying->Замёрзший легион сплочения
Immortal Call->Призыв к бессмертию
Protective Link->Ограждающая связь
Summon Flame Golem->Призыв голема огня
Summon Flame Golem of Hordes->Призыв голема огня орды
Summon Flame Golem of the Meteor->Призыв голема огня метеора
Summon Stone Golem->Призыв каменного голема
Summon Stone Golem of Hordes->Призыв каменного голема орды
Summon Stone Golem of Safeguarding->Призыв каменного голема охраны
Vaal Immortal Call->Призыв к бессмертию ваал
Burning Arrow->Горящая стрела
Burning Arrow of Vigour->Горящая стрела мощи
Cobra Lash->Бросок кобры
Double Strike->Двойной удар
Double Strike of Impaling->Двойной удар прокола
Double Strike of Momentum->Двойной удар импульса
Dual Strike->Парный удар
Dual Strike of Ambidexterity->Парный удар амбидекстрии
Ethereal Knives->Бесплотные ножи
Ethereal Knives of Lingering Blades->Бесплотные ножи остаточных клинков
Ethereal Knives of the Massacre->Бесплотные ножи резни
Frost Blades->Ледяные клинки
Frost Blades of Katabasis->Ледяные клинки катабасиса
Ice Shot->Ледяной выстрел
Ice Shot of Penetration->Ледяной выстрел пронзания
Caustic Arrow->Едкая стрела
Caustic Arrow of Poison->Едкая стрела яда
Galvanic Arrow->Электризующая стрела
Galvanic Arrow of Energy->Электризующая стрела энергии
Galvanic Arrow of Surging->Бушующая электризующая стрела
Explosive Trap->Взрывная ловушка
Explosive Trap of Shrapnel->Взрывная ловушка осколков
Explosive Trap of Magnitude->Взрывная ловушка интенсивности
Split Arrow->Расколотая стрела
Split Arrow of Splitting->Расколотая стрела раскалывания
Splitting Steel->Раскалывающая сталь
Splitting Steel of Ammunition->Раскалывающая сталь боезапаса
Spectral Throw->Призрачный бросок
Spectral Throw of Materialising->Призрачный бросок воплощения
Vaal Burning Arrow->Горящая стрела ваал
Vaal Caustic Arrow->Едкая стрела ваал
Vaal Double Strike->Двойной удар ваал
Vaal Ice Shot->Ледяной выстрел ваал
Vaal Spectral Throw->Призрачный бросок ваал
Viper Strike->Удар гадюки
Viper Strike of the Mamba->Удар гадюки Мамбы
Animate Weapon->Живое оружие
Animate Weapon of Self Reflection->Живое оружие отражения
Animate Weapon of Ranged Arms->Живое оружие дальнего боя
Bear Trap->Медвежий капкан
Bear Trap of Skewers->Медвежий капкан пронзения
Dash->Рывок
Detonate Dead->Подрыв трупа
Detonate Dead of Scavenging->Подрыв трупа поглощения
Detonate Dead of Chain Reaction->Подрыв трупа цепной реакции
Sniper's Mark->Метка снайпера
Puncture->Надрез
Riposte->Парирование
Shrapnel Ballista->Осколочная баллиста
Shrapnel Ballista of Steel->Стальная осколочная баллиста
Vaal Animate Weapon->Живое оружие ваал
Vaal Detonate Dead->Подрыв трупа ваал
Blink Arrow->Стрела-телепорт
Blink Arrow of Bombarding Clones->Стрела-телепорт бомбардирующих клонов
Blink Arrow of Prismatic Clones->Стрела-телепорт радужных клонов
Unearth->Эксгумация
Flicker Strike->Внезапный удар
Flicker Strike of Power->Внезапный удар энергии
Mirror Arrow->Стрела-двойник
Mirror Arrow of Bombarding Clones->Стрела-двойник бомбардирующих клонов
Mirror Arrow of Prismatic Clones->Стрела-двойник радужных клонов
Precision->Точность
Smoke Mine->Дымовая мина
Vaal Flicker Strike->Внезапный удар ваал
Whirling Blades->Шквал клинков
Withering Step->Губительный шаг
Barrage->Очередь
Barrage of Volley Fire->Очередь залпов
Blade Trap->Ловушка лезвий
Blade Trap of Greatswords->Ловушка лезвий с большими мечами
Blade Trap of Laceration->Ловушка лезвий разрубания
Blade Vortex->Вихрь клинков
Blade Vortex of the Scythe->Вихрь клинков косы
Elemental Hit->Удар стихии
Elemental Hit of the Spectrum->Спектральный удар стихии
Fire Trap->Огненная ловушка
Fire Trap of Blasting->Огненная ловушка взрывов
Lacerate->Разрубание
Lacerate of Butchering->Разрубание туш
Lacerate of Haemorrhage->Разрубание кровоизлияния
Lightning Arrow->Стрела молнии
Lightning Arrow of Electrocution->Стрела молнии проводимости
Lightning Strike->Удар молнии
Lightning Strike of Arcing->Удар цепной молнии
Poisonous Concoction->Ядовитая смесь
Poisonous Concoction of Bouncing->Отскакивающая ядовитая смесь
Rain of Arrows->Ливень стрел
Rain of Arrows of Artillery->Артиллерийский ливень стрел
Rain of Arrows of Saturation->Ливень стрел насыщения
Reave->Опустошение
Reave of Refraction->Преломляющее опустошение
Shattering Steel->Дробящая сталь
Shattering Steel of Ammunition->Дробящая сталь боезапаса
Siege Ballista->Осадная баллиста
Siege Ballista of Splintering->Осадная баллиста осколков
Spectral Helix->Призрачная спираль
Toxic Rain->Токсичный дождь
Toxic Rain of Sporeburst->Токсичный дождь выброса спор
Toxic Rain of Withering->Токсичный дождь увядания
Vaal Blade Vortex->Вихрь клинков ваал
Vaal Lightning Arrow->Стрела молнии ваал
Vaal Lightning Strike->Удар молнии ваал
Vaal Rain of Arrows->Ливень стрел ваал
Vaal Reave->Опустошение ваал
Vaal Venom Gyre->Круг яда ваал
Venom Gyre->Круг яда
Volatile Dead->Нестабильный труп
Volatile Dead of Confinement->Заточенный нестабильный труп
Volatile Dead of Seething->Бурлящий нестабильный труп
Arctic Armour->Северная броня
Blade Blast->Взрыв клинков
Blade Blast of Unloading->Взрыв клинков разрядки
Blade Blast of Dagger Detonation->Взрыв клинков кинжалов
Blood Rage->Кровавый угар
Desecrate->Осквернение
Ensnaring Arrow->Стрела ловчего
Frenzy->Бешенство
Frenzy of Onslaught->Бешенство боевого ража
Herald of Agony->Вестник агонии
Herald of Ice->Вестник льда
Poacher's Mark->Метка браконьера
Vaal Arctic Armour->Северная броня ваал
Alchemist's Mark->Метка алхимика
Purity of Ice->Спасение от холода
Grace->Грация
Haste->Спешка
Hatred->Холодная ненависть
Plague Bearer->Носитель чумы
Temporal Chains->Путы времени
Vaal Impurity of Ice->Погибель от холода ваал
Vaal Grace->Грация ваал
Vaal Haste->Спешка ваал
Artillery Ballista->Артиллерийская баллиста
Artillery Ballista of Cross Strafe->Артиллерийская баллиста перекрестного огня
Artillery Ballista of Focus Fire->Артиллерийская баллиста прицельного огня
Bladefall->Мечепад
Bladefall of Volleys->Мечепад града
Bladefall of Impaling->Мечепад пронзания
Blast Rain->Дождь взрывов
Blade Flurry->Порыв клинков
Blade Flurry of Incision->Порыв клинков надреза
Charged Dash->Заряженный рывок
Cremation->Кремация
Cremation of Exhuming->Кремация эксгумации
Cremation of the Volcano->Кремация вулкана
Cyclone->Вихрь
Cyclone of Tumult->Вихрь буйства
Explosive Arrow->Взрывная стрела
Explosive Concoction->Взрывная смесь
Explosive Concoction of Destruction->Взрывная смесь разрушения
Flamethrower Trap->Ловушка-огнемёт
Ice Trap->Ледяная ловушка
Ice Trap of Hollowness->Ледяная ловушка пустоты
Lancing Steel->Пронзающая сталь
Lancing Steel of Spraying->Пронзающая сталь разброса
Pestilent Strike->Моровой удар
Seismic Trap->Сейсмическая ловушка
Seismic Trap of Swells->Сейсмическая ловушка волн
Scourge Arrow->Стрела скверны
Scourge Arrow of Menace->Стрела скверны угрозы
Storm Rain->Грозовой дождь
Storm Rain of the Conduit->Грозовой дождь проводника
Storm Rain of the Fence->Заградительный грозовой дождь
Spectral Shield Throw->Бросок призрачного щита
Spectral Shield Throw of Shattering->Призрачный бросок щита разбивания
Tornado Shot->Вихрь стрел
Tornado Shot of Cloudburst->Вихрь стрел раскатов
Vaal Blade Flurry->Порыв клинков ваал
Vaal Cyclone->Вихрь ваал
Wild Strike->Шальной удар
Wild Strike of Extremes->Шальной удар полярности
Ambush->Задача
Snipe->Прицельный выстрел
Intuitive Link->Подсознательная связь
Phase Run->Призрачный бег
Summon Ice Golem->Призыв голема льда
Summon Ice Golem of Hordes->Призыв голема льда орды
Summon Ice Golem of Shattering->Призыв голема льда разбивания
Temporal Rift->Временной разрыв
Tornado->Торнадо
Tornado of Elemental Turbulence->Торнадо стихийной хаотичности
Vampiric Link->Иссушающая связь
Lightning Tendril->Кровавый дождь
Ice Spear->Переплетение
Fireball->Пылающий поток
Flame Surge->Искажённый удар
Wintertide->Ледяной шип
Frost Nova->Цепь молний
Plasma Geyser->Некротица
Chain Lightning->Ураган
Shockwave->Лунный свет
Blazing Barrage->Ледяное дыхание
Emberstorm->Ослепляющий свет
Soul Siphon->Сила бурь
Blood Orb->Защитный круг
Area Overload->Ядовитая пыль
Flame Burst->Тёмная завеса
Flash Freeze->Пламя боли
Arcane Surge->Стрела смерти
Firestorm->Жалящий удар
Black Hole->Восстановление
Spirit Barrier->Очищение
Raging Inferno->Песчаный шторм
Astral Projection->Обманчивый свет
Elemental Armor->Проклятие
Shield of Valor->Ветер перемен
Icy Veins->Ярость
Arcane Fire->Поражение
Arcane Shield->Уничтожение
Randomizer->Небесное величие
Echoing Null->Слепящая тьма
Frigid Spikes->Рывок
Burning Surge->Ловкость
Tidal Wave->Устойчивость
Starfall->Печать
Radiant Beam->Обсидиановая парча
Arcane Blast->Рвущая стена
Silencing Wave->Призрачная тень
Bouncing Blast->Ледяной кошмар
Runic Shield->Ураган огня
Fiery Chains->Мыслительная связь
Ice Barrier->Тоннель
Summoning Ray->Лунная пыль
Elemental Shield->Сила света
Time Warp->Ограничение
Glacial Field->Первая капля
Electroshock->Разрушитель
Searing Wave->Яркий луч
Vacuum Aura->Отражение
Beacon of Light->Ледяная преграда
Shock Strike->Пламенный след
Oppressive Force->Клинок правосудия
Helios Beam->Ослепляющий удар
Plague Wave->Вечный огонь
Demonic Helix->Зов
Shadow Bolt->Мыслительная проекция
Serpent's Grasp->Искра хаоса
Ethereal Chains->Разделение
Mystic Flames->Образ бури
Hydromancer's Call->Забвение
Fiery Gauntlet->Ледяная смерть
Warding Shield->Проклятие скверны
Arcane Chains->Удар Молнии
Shadow Cloak->Зов сокрытой силы
Storm Shield->Небесное воробей
Torrent->Буря
Healing Beam->Стихийный взрыв
Ethereal Blades->Глубокое пробуждение
Blinding Radiance->Удары земли
Infernal Web->Удар мракобесия
Celestial Grasp->Призрак света
Healing Ward->Прощение
Hailstorm->Ледяное пробуждение
Flickering Flash->Крик природы
Resonance->Темный поток
Soul Harvest->Оборона
Fractured Light->Небесная тень
Moonbeam->Древний взрыв
Echo Chamber->Проклятие хаоса
Sinister Whispers->Обход
Tidal Surge->Призрачный блеск
Stone Skin->Пламя
Empowering Ring->Ядовитый взрыв
Heat Wave->Светлый взгляд
Arcane Mirage->Солнечное затмение
Liquid Fire->Опустошение
Tornado Strike->Волшебный щит
Rage Burst->Жрецы света
Searing Chains->Печать ярости
Warding Aura->Мгла
Mystic Shield->Люция
Ice Shield->Огненная струя
Elemental Explosion->Обездвиживание
Stalwart Bulwark->Путешествие
Twisting Phantasm->Носитель иллюзий
Nightmare Realm->Татарин
Ethereal Flame->Снегопад
Luminous Wave->Сингулярность
Chaos Shield->Истребление
Blade Fury->Исцеление
Burning Ash->Буря стихий
Celestial Flash->Пылающий штык
Time Distortion->Наступление
Frostbite->Сырое время
Ebon Shields->Небо
Gale Winds->Гладь
Whispering Shadows->Погружение
Draining Pulse->Изгнание
Mystic Circle->Метаморфозы
Ice Fortress->Тьма
Cleansing Rain->Песок
Frozen Shield->Равнина
Whirling Storm->Бурьян
Celestial Song->Ярость природы
Ensnaring Strike->Свет
Ice Blight->Истребить
Astral Shield->Уничтожить
Fateful Blow->Счастье
Volatile Breath->Перемена
Fractured Sphere->Нападение
Mystic Blast->Прощение
Shear Storm->Поразить
Vaporous Step->Силы тьмы
Shadow Surge->Очистка
Arcane Leap->Смятение
Pulsing Surge->Тишина
Ethereal Burst->Крик волка
Storm Scourge->Небесная фурия
Frosty Gale->Откровение
Pyromancer's Call->Первая воля
Radiant Echo->Последствия
Blazing Chain->Временами
Searing Elixir->Усыновление
Soul Fire->Эпопея
Ethereal Flight->Ураган могущества
Flame Rush->Направление
Shadow Dance->Зов
Froststorm->Некромантия
Arcane Torrent->Тайный путь
Steadfast Arrow->Наказание
Gale Blade->Взрыв
Mystic Rain->Печать стихий
Icy Breath->Сумрак
Draining Shadow->Нападение тьмы
Shadow Miasma->Тёмный свет
Ebon Wave->Лунный удар
Flame Burst->Ледяной удар
Ethereal Cage->Проклятие сокрушения
Shadow Prism->Страдание
Frost Cloak->Ветры войны
Echo Mirage->Священные вершины
Glacial Veil->Разгром
Stormfront->Торжество
Frost Shard->Переплетение
Twisting Chain->Песня
Mystic Whispers->Признание
Celestial Charge->Конец света
Inferno Blast->Странствия
Searing Flare->Долг
Poisoned Blade->Ясность
Elemental Fury->Странник
Shattering Wave->Удары
Shadow Spiral->Оживление
Ethereal Scream->Паутина
Frigid Grasp->Восхождение
Soul Bind->Перемены
Night Stalker->Глубь
Time Shatter->Призыв
Unholy Blade->Стрелы
Scorching Ray->Устойчивый
Shattered Light->Человек-тень
Cyclone Strike->Блуждание
Arcane Slumber->Будущее
Flame Offense->Наказание
Icy Grasp->Укрепление
Purifying Light->Череда
Geyser->Подсказка
Ethereal Glow->Ярость
Storm Servant->Погружение
Celestial Flare->Тьма
Rays of Light->Мглистый
Frost Bite->Грех
Healing Circle->Панда
Mystic Light->Игра
Radiant Shield->Светлая
Mystic Shard->Исчерпание
Ebon Gale->Наступление
Arcane Grasp->Укрытие
Emberstorm->Исцеление
Shadows of Time->Призыв
Frigid Chain->Опасность
Burning Fury->Непогода
Stormcloud->Партнёр
Ethereal Wave->Разметка
Arcane Rift->Прощение
Frozen Vortex->Устойчивый
Fiery Geyser->Изменение
Shadow Weaver->Поток
Solar Flare->Надежда
Arcane Blight->Пробуждение
Enveloping Darkness->Путь
Fractured Glimmer->Вызов
Celestial Shield->Подстраховка
Shattering Echo->Безмолвие
Elusive Strike->Покровительство
Frost Lance->Сила
Ethereal Burst->Грань
Reckless Flames->Устойчивость
Gale Strike->Справедливость
Shimmering Aura->Откровение
Arcane Nova->Телекинез
Tornadic Blast->Устойчивость
Unyielding Flames->Течение



//////////////////////////////// Ископаемые //////////////////////////////////
Fossils->Ископаемые
Aberrant Fossil->Искажённое ископаемое
Aetheric Fossil->Эфирное ископаемое
Bloodstained Fossil->Окровавленное ископаемое
Bound Fossil->Связующее ископаемое
Corroded Fossil->Пористое ископаемое
Dense Fossil->Плотное ископаемое
Faceted Fossil->Гранёное ископаемое
Fractured Fossil->Треснувшее ископаемое
Frigid Fossil->Ледяное ископаемое
Gilded Fossil->Позолоченное ископаемое
Glyphic Fossil->Резное ископаемое
Hollow Fossil->Пустое ископаемое
Jagged Fossil->Шероховатое ископаемое
Lucent Fossil->Светлое ископаемое
Metallic Fossil->Металлическое ископаемое
Perfect Fossil->Безупречное ископаемое
Prismatic Fossil->Радужное ископаемое
Pristine Fossil->Чистое ископаемое
Sanctified Fossil->Освящённое ископаемое
Scorched Fossil->Опалённое ископаемое
Serrated Fossil->Зубчатое ископаемое
Shuddering Fossil->Дрожащее ископаемое
Tangled Fossil->Замысловатое ископаемое
Deft Fossil->Проворное ископаемое
Fundamental Fossil->Фундаментальное ископаемое


//////////////////////////////// Резонаторы //////////////////////////////////
Resonators->Резонаторы
Potent Chaotic Resonator->Активный хаотический резонатор
Powerful Chaotic Resonator->Мощный хаотический резонатор
Prime Chaotic Resonator->Превосходный хаотический резонатор
Primitive Chaotic Resonator->Простейший хаотический резонатор


//////////////////////////////// Сущности //////////////////////////////////
Essences->Сущности
Deafening Essence of Torment->Оглушающая сущность ненависти
Deafening Essence of Wrath->Оглушающая сущность печали
Deafening Essence of Spite->Оглушающая сущность страдания
Deafening Essence of Rage->Оглушающая сущность ярости
Deafening Essence of Anger->Оглушающая сущность злобы
Deafening Essence of Anguish->Оглушающая сущность горя
Deafening Essence of Hatred->Оглушающая сущность мучения
Deafening Essence of Sorrow->Оглушающая сущность гнева
Deafening Essence of Suffering->Оглушающая сущность неприязни
Deafening Essence of Envy->Оглушающая сущность зависти
Deafening Essence of Woe->Оглушающая сущность скорби
Deafening Essence of Greed->Оглушающая сущность жадности
Deafening Essence of Contempt->Оглушающая сущность презрения
Deafening Essence of Fear->Оглушающая сущность страха
Deafening Essence of Doubt->Оглушающая сущность сомнения
Deafening Essence of Loathing->Оглушающая сущность отвращения
Deafening Essence of Zeal->Оглушающая сущность усердия
Deafening Essence of Misery->Оглушающая сущность тоски
Deafening Essence of Dread->Оглушающая сущность жути
Deafening Essence of Scorn->Оглушающая сущность насмешки
Shrieking Essence of Torment->Визжащая сущность ненависти
Shrieking Essence of Wrath->Визжащая сущность печали
Shrieking Essence of Spite->Визжащая сущность страдания
Shrieking Essence of Rage->Визжащая сущность ярости
Shrieking Essence of Anger->Визжащая сущность злобы
Shrieking Essence of Anguish->Визжащая сущность горя
Shrieking Essence of Hatred->Визжащая сущность мучения
Shrieking Essence of Sorrow->Визжащая сущность гнева
Shrieking Essence of Suffering->Визжащая сущность неприязни
Shrieking Essence of Envy->Визжащая сущность зависти
Shrieking Essence of Woe->Визжащая сущность скорби
Shrieking Essence of Greed->Визжащая сущность жадности
Shrieking Essence of Contempt->Визжащая сущность презрения
Shrieking Essence of Fear->Визжащая сущность страха
Shrieking Essence of Doubt->Визжащая сущность сомнения
Shrieking Essence of Loathing->Визжащая сущность отвращения
Shrieking Essence of Zeal->Визжащая сущность усердия
Shrieking Essence of Misery->Визжащая сущность тоски
Shrieking Essence of Dread->Визжащая сущность жути
Shrieking Essence of Scorn->Визжащая сущность насмешки
Essence of Delirium->Сущность бреда
Essence of Hysteria->Сущность истерии
Essence of Insanity->Сущность безумия
Essence of Horror->Сущность ужаса
Screaming Essence of Torment->Кричащая сущность ненависти
Screaming Essence of Wrath->Кричащая сущность печали
Screaming Essence of Spite->Кричащая сущность страдания
Screaming Essence of Rage->Кричащая сущность ярости
Screaming Essence of Anger->Кричащая сущность злобы
Screaming Essence of Anguish->Кричащая сущность горя
Screaming Essence of Hatred->Кричащая сущность мучения
Screaming Essence of Sorrow->Кричащая сущность гнева
Screaming Essence of Suffering->Кричащая сущность неприязни
Screaming Essence of Envy->Кричащая сущность зависти
Screaming Essence of Woe->Кричащая сущность скорби
Screaming Essence of Greed->Кричащая сущность жадности
Screaming Essence of Contempt->Кричащая сущность презрения
Screaming Essence of Fear->Кричащая сущность страха
Screaming Essence of Doubt->Кричащая сущность сомнения
Screaming Essence of Loathing->Кричащая сущность отвращения
Screaming Essence of Zeal->Кричащая сущность усердия
Screaming Essence of Misery->Кричащая сущность тоски
Screaming Essence of Dread->Кричащая сущность жути
Screaming Essence of Scorn->Кричащая сущность насмешки
Remnant of Corruption->След Порчи
Wailing Essence of Torment->Вопящая сущность ненависти
Wailing Essence of Wrath->Вопящая сущность печали
Wailing Essence of Spite->Вопящая сущность страдания
Wailing Essence of Rage->Вопящая сущность ярости
Wailing Essence of Anger->Вопящая сущность злобы
Wailing Essence of Anguish->Вопящая сущность горя
Wailing Essence of Hatred->Вопящая сущность мучения
Wailing Essence of Sorrow->Вопящая сущность гнева
Wailing Essence of Suffering->Вопящая сущность неприязни
Wailing Essence of Woe->Вопящая сущность скорби
Wailing Essence of Greed->Вопящая сущность жадности
Wailing Essence of Contempt->Вопящая сущность презрения
Wailing Essence of Fear->Вопящая сущность страха
Wailing Essence of Doubt->Вопящая сущность сомнения
Wailing Essence of Loathing->Вопящая сущность отвращения
Wailing Essence of Zeal->Вопящая сущность усердия
Weeping Essence of Torment->Плачущая сущность ненависти
Weeping Essence of Wrath->Плачущая сущность печали
Weeping Essence of Rage->Плачущая сущность страдания
Weeping Essence of Anger->Плачущая сущность ярости
Weeping Essence of Hatred->Плачущая сущность злобы
Weeping Essence of Sorrow->Плачущая сущность мучения
Weeping Essence of Suffering->Плачущая сущность гнева
Weeping Essence of Woe->Плачущая сущность скорби
Weeping Essence of Greed->Плачущая сущность жадности
Weeping Essence of Contempt->Плачущая сущность презрения
Weeping Essence of Fear->Плачущая сущность страха
Weeping Essence of Doubt->Плачущая сущность сомнения
Muttering Essence of Torment->Бормочущая сущность ненависти
Muttering Essence of Anger->Бормочущая сущность печали
Muttering Essence of Hatred->Бормочущая сущность злобы
Muttering Essence of Sorrow->Бормочущая сущность мучения
Muttering Essence of Woe->Бормочущая сущность скорби
Muttering Essence of Greed->Бормочущая сущность жадности
Muttering Essence of Contempt->Бормочущая сущность презрения
Muttering Essence of Fear->Бормочущая сущность страха
Whispering Essence of Hatred->Шепчущая сущность ненависти
Whispering Essence of Woe->Шепчущая сущность скорби
Whispering Essence of Greed->Шепчущая сущность жадности
Whispering Essence of Contempt->Шепчущая сущность презрения



//////////////////////////////// звери //////////////////////////////////
Beasts->Звери
Cave Beast->Пещерный зверь
Enraptured Beast->Завороженный зверь
Enraptured Beast->Завороженный зверь
Primal Beast->Доисторический зверь
The Alpha Beast->Первородный зверь
Bone Cruncher->Костолом
Hairy Bonecruncher->Лохматый костолом
Shaggy Monstrosity->Косматая образина
Thicket Hulk->Чащобная громадина
Skeletal Beast->Костяк зверя
Corrupted Beast->Искажённый зверь
Armour Cruncher->Крушитель
Forest Beast->Лесной зверь
Goatman->Козерог
Goatman Stomper->Козерог-топтун
Bearded Devil->Бородатый дьявол
Alpine Devil->Горный дьявол
Bearded Devil->Бородатый дьявол
Goatman Shaman->Шаман козерогов
Goatman Fire-raiser->Козерог-заклинатель огня
Bearded Shaman->Бородатый шаман
Bearded Skycaller->Бородатый призыватель небес
Alpine Shaman->Горный шаман
Hill Devil->Дьявол холма
Colossus Crusher->Гигантский крушитель
Arctic Wolf->Северный волк
Snow Wolf->Снежный волк
Freezing Wolf->Морозный волк
Dire Wolf->Лютоволк
Flame Hellion->Огненный адский лев
Dune Hellion->Барханный адский лев
Ruins Hellion->Адский лев из развалин
Mountain Hellion->Горный адский лев
Mountain Hellion Alpha->Горный адский лев-альфа
Enslaved Hellion->Порабощенный адский лев
Enslaved Hellion->Порабощенный адский лев
Shackled Hellion->Пленённый адский лев
Blood Ape->Кровавый примат
Dread Primate->Жуткий примат
Dread Primate->Жуткий примат
Stygian Ape->Адский примат
Infested Ape->Заражённый примат
Infested Ape->Заражённый примат
Blood Chieftain->Вожак кровавых обезьян
Carnage Chieftain->Буйствующий вожак обезьян
Stygian Silverback->Вожак адских обезьян
Aboriginal Chieftain->Вожак доисторических обезьян
Host Chieftain->Вожак-переносчик
Host Chieftain->Вожак-переносчик
Carnage Ape->Примат убийца
Barrow Ape->Холмовой примат
Primitive Ape->Примитивный примат
Rhoa Mare->Самка роа
Primordial Rhoa->Доисторический роа
Tercel Rhoa->Роа-самец
Murk Runner->Тёмный бегун
Bone Rhoa->Костяной роа
Corrupted Rhoa->Искажённый роа
Bone Scavenger->Костяной роа-стервятник
Zombie Rhoa->Зомби-роа
Infested Rhoa->Заражённый роа
Gravel Eater->Галечник
Fossil Eater->Ископаемый плевун
Scrabbling Spitter->Плевун-копатель
Granite Eater->Гранитный плевун
Rock Spitter->Каменный плевун
Crustacean Sniper->Рак-стрелок
Crustacean Pelter->Рак-метатель
Infested Sniper->Заражённый стрелок
Obsidian Eater->Обсидиановый плевун
Crustacean Sniper->Рак-стрелок
Merveil's Favoured->Приближенный Мервейл
Merveil's Daughter->Дочь Мервейл
Merveil's Attendant->Свита Мервейл
Merveil's Chosen->Избранник Мервейл
Merveil's Retainer->Слуга Мервейл
Singing Siren->Поющая сирена
Merveil's Blessed->Блаженная Мервейл
Fated Siren->Сирена из пророчества
Night Adder->Ночной уж
Host Adder->Уж-переносчик
Host Adder->Уж-переносчик
Bramble Cobra->Игольчатая кобра
Host Cobra->Змей-переносчик
Host Cobra->Змей-переносчик
Acid Slitherer->Кислотный ползун
Glade Mamba->Лесной аспид
Cursed Spawn->Проклятый ужас
Fathom Screamer->Призрачный крикун
Siren's Spawn->Выродок сирены
Slimy Bloodsucker->Мерзкий кровосос
Foreseen Spawn->Порождение пророчества
Slimy Nemesis->Мерзкий мститель
Venomous Spawn->Ядовитый выродок
Lurking Venom->Таящийся отравитель
Vaal Recluse->Отшельник ваал
Noxious Tarantula->Ядовитый птицеед
Deadly Tarantula->Смертоносный птицеед
Leaping Spider->Прыгающий паук
Arakaali's Daughter->Дочь Аракаали
Webbed Spider->Затянутый паутиной паук
Virulent Spider->Ядовитый паук
Ink Spinner->Чернопряд
Corrupted Arach->Заражённый арахнид
Crypt Weaver->Подземельный ткач
Mutant Arach->Изуродованный арахнид
Crypt Ambusher->Могильный охотник
Corrupted Spitter->Ядовитый плевун
Cave Skitterer->Пещерный легколап
Spindle Spider->Веретянщик
Hatchling->Малёк
Brooding Tarantula->Мрачный птицеед
Buried Tarantula->Зарывающийся птицеед
Maligaro's Inspiration->Вдохновение Малигаро
Enraptured Arachnid->Завороженный арахнид
Enraptured Arachnid->Завороженный арахнид
Fetid Maw->Зловонная пасть
Filth Maw->Мерзкая пасть
Bestial Maw->Звериная пасть
Infested Maw->Заражённая пасть
Infested Maw->Заражённая пасть
Plumed Chimeral->Пернатый ящер
Feral Chimeral->Одичавший ящер
Chrome-touched Chimeral->Зеркальный ящер
Chrome-infused Chimeral->Хромовый ящер
Wild Chimeral->Дикий ящер
Chimeric Croaker->Химеровый квакун
Vaulting Croaker->Скачущий квакун
Chrome-touched Croaker->Зеркальный квакун
Chrome-infused Croaker->Хромовый квакун
Carrion Queen->Матка трупоедов
Carrion Swarmer->Мерзкий жук
Carrion Burrower->Мерзкий копатель
Scum Crawler->Сточник
Nightmarish Carrion->Кошмарная гниль
Nightmarish Crawler->Кошмарный ползун
Avian Retch->Пернатый рыгатель
Gluttonous Gull->Ненасытный падальщик
Sewage Crawler->Нечистотник
Toxic Crawler->Ядовитый нечистотник
Spine Serpent->Шипастый змей
Infested Serpent->Заражённый змей
Barb Serpent->Колючюй змей
Sand Serpent->Песчаный змей
Porcupine Goliath->Дикобразный исполин
Chrome-touched Goliath->Зеркальный исполин
Chrome-infused Goliath->Хромовый исполин
Devourer->Пожиратель
Ancient Devourer->Старейший пожиратель
Soulless Watcher->Безучастный смотритель
Drifting Eye->Плывущий глаз
Cavern Drifter->Пещерный плывун
Sewer Drifter->Сточный плывун
Infected Watcher->Заражённый смотритель
Plummeting Ursa->Падучий медведь
Plummeting Ursa->Падучий медведь
Tunnelfiend->Верхолаз
Tunnelfiend->Верхолаз
Infested Tunnelfiend->Заражённый верхолаз
Infested Tunnelfiend->Заражённый верхолаз
Woods Ursa->Лесной медведь
Woods Ursa->Лесной медведь
Infested Ursa->Заражённый медведь
Infested Ursa->Заражённый медведь
Sickly Spinner->Больной паутинник
Infected Spiker->Заражённый иглогрив
Infected Beast->Заражённый зверь
Rabid Broodqueen->Заражённый вожак
Rabid Minion->Заражённый прислужник
Crazed Chieftain->Обезумевший вожак обезъян
Putrid Chimeral->Гниющая химера
Infected Ambusher->Заражённая невидь
Plummeting Ursa->Падучий медведь
Crazed Flamebeast->Обезумевший жарошкур
Infected Rhoa->Заражённый роа
Rabid Rhoa->Бешеный роа
Putrid Weaver->Гниющий ткач
Infected Adder->Заражённый аспид
Putrid Serpent->Гниющий змей
Rabid Maw->Бешеная пасть
Fused Crawler->Размякший панцерник
Mindless Scavenger->Безмозглый мусорщик
Scavenging Vulture->Всеядный гриф
Rotting Vulture->Гниющий гриф
Infested Vulture->Заражённый гриф
Dust Scrabbler->Пыльный норовик
Dust Scrabbler->Пыльный норовик
Dirt Scrabbler->Грязевой норовик
Infested Skitterer->Заражённый легколап
Lowlands Hopper->Равнинный скакун
Sand Skitterer->Песчаный быстроног
Sand Leaper->Песчаный прыгун
Fury Hound->Огненный пёс
War Hound->Боевой пёс
Pitbull Demon->Демон-пёс
Vicious Hound->Яростная гончая
Rooster Fiend->Исчадие-задира
Rooster Demon->Демон-задира
Talon Archer->Когтистый лучник
Feral Fowl->Дикий кокатрикс
Fighting Bull->Бойцовый бык
Avalanche Rider->Лавинный всадник
Grazing Taurus->Пасущийся телец
Savage Crab->Свирепый краб
Infested Crawler->Заражённый ползун
Infested Crab->Заражённый краб
Enraptured Crab->Завороженный краб
Infested Crawler->Заражённый ползун
Bleached Crawler->Выбеленный ползун
Echo of the Verdant->Эхо зелени
Echo of the Verdant->Эхо зелени
Maze Webspinner->Лабиринтный паутинник
Maze Hatchling->Лабиринтный паучок
Devourer->Пожиратель
Maze Needleback->Лабиринтный игольник
Maze Slitherer->Лабиринтный ползун
Parasite->Паразит
Ravenous Parasite->Голодный паразит
Vicious Parasite->Ужасный паразит
Poisonous Parasite->Ядовитый паразит
Plated Parasite->Пластинчатый паразит
Spitting Parasite->Паразит-плевун
Brine Vassal->Морской слуга
Swarthy Mollusc->Тёмный моллюск
Purge Hound->Гончая очищения
Purge Hound->Гончая очищения
Sulphurspawn->Серное отродье
Plagued Arachnid->Чумной арахнид
Diseased Arachnid->Отравленный арахнид
Maligaro's Muse->Муза Малигаро
Hybrid Arachnid->Гибридный арахнид
Scalding Arachnid->Едкий арахнид
Waste Lurcher->Сточный ползун
Wild Rhex->Дикий рекс
Maternal Rhex->Созревший рекс
Adolescent Rhex->Рекс-детёныш
Escaped Rhex->Беглый рекс
Black Scorpion->Чёрный скорпион
Sulphuric Scorpion->Серный скорпион
Sand Scorpion->Песчаный скорпион
Predatory Scorpion->Хищный скорпион
Mountain Lynx->Горная рысь
Spider Crab->Краб-паук
Skitterling->Малёк-прыгун
Azurite Widow->Азуритовая вдова
Cave Weta->Пещерный кузнечик
Unstable Weta->Нестабильный кузнечик
Cavestalker->Пещерный охотник
Azure Ape->Лазурный примат
Gorgol Alpha->Горгол-альфа
Azure Shrieker->Лазурный визгун
Charged Shrieker->Заряженный визгун
Wild Bristle Matron->Дикая щетинистая матрона
Wild Hellion Alpha->Дикий адский лев-альфа
Wild Brambleback->Дикий шипоспин
Vivid Watcher->Буйный наблюдатель
Vivid Vulture->Буйный стервятник
Vivid Abberarach->Буйный арахнион
Primal Rhex Matriarch->Первобытная рекс-матриарх
Primal Crushclaw->Первобытный клешнелом
Primal Cystcaller->Первобытный наростень
The Great White Beast->Великий белый зверь
The Great White Bones->Великие белые кости
Tyrannursus Maximus->Тиранурсус Максимус
Elder-Blessed Goatman->Благословленный Древним козерог
The Faun->Фавн
Ungulath->Унгулат
Elder-Blessed Hellion->Благословленный Древним адский лев
The Burning Menace->Горящая угроза
Nadia the Soothing->Надя Кроткая
Aidan the Frenzied->Эйдан Бешеный
Hollowskull, the Willing Host->Пусточереп, Послушный переносчик
Elder-Blessed Rhoa->Благословленный Древним роа
Albino Rhoa->Роа-альбинос
Oozeback Bloom->Илистый грязеспин
Ventarus->Вентарус
The Dweller of the Deep->Обитатель глубин
Ambrosia, Daughter of Merveil->Амброзия, дочь Мервейл
Amarissa, Daughter of Merveil->Амарантия, дочь Мервейл
Brood Princess->Царевна выводка
Scrabbling Menace->Царапающая угроза
Cave Crustacean->Пещерный краб
Invading Crustacean->Нападающий краб
Infested Crustacean->Заражённый краб
Deep Crustacean->Глубинный краб
Deep Crustacean->Глубинный краб
Shield Crab->Крепкий краб
Bleached Crustacean->Иссушенный краб
Elder-Blessed Cobra->Благословленная Древним кобра
Unstable Larva->Нестабильный кальмар
Black Death->Чёрная смерть
The Weaver->Ткачиха
Balah, Duke->Бала
Paradisae Venenum->Райский Ядоклюв
Carrion Minion->Мерзкий выродок
Elder-Blessed Retch->Благословленный Древним рыгатель
Thistlesage->Чертополох
Spirit of Nadia->Дух Нади
Spirit of Aidan->Дух Эйдана
Tunnelworm->Подземный поглотитель
The Conqueror Wurm->Змей Завоеватель
Mystic Devourer->Таинственный пожиратель
Q'uru->К'уру
The All-seeing Eye->Всевидящее око
The All-seeing Eye->Всевидящее око
Konu, Maker of Wind->Кону, Гонитель ветров
Konu, Maker of Wind->Кону, Гонитель ветров
Sheaq, Maker of Floods->Шиак, Собиратель туч
Sheaq, Maker of Floods->Шиак, Собиратель туч
Kamaq, Soilmaker->Кэмак, Маратель
Kamaq, Soilmaker->Кэмак, Маратель
Inti of the Blood Moon->Инти Кроваволунный
Inti of the Blood Moon->Инти Кроваволунный
Simi, the Nature Touched->Сими, Помазанный природой
Simi, the Nature Touched->Сими, Помазанный природой
The Sunburst Queen->Солнцеликая царица
The Sunburst Queen->Солнцеликая царица
Cintiq, the Inescapable->Синтик, Неотвратимый
Cintiq, the Inescapable->Синтик, Неотвратимый
Thornrunner->Шипоносец
Thornrunner->Шипоносец
Mother of the Hive->Королева улья
Rima, Deep Temptress->Рима, Греховодница из глубин
Rima, Deep Temptress->Рима, Греховодница из глубин
Quetzerxi->Квецеркси
Marrowcrush->Костомел
The Cadaver Bull->Бодливый остов
Junglemare->Мать джунглей
Blood Stasis->Кровавый усыпитель
Blood Morpher->Кровавый погонщик
Spinesnap->Кусака
Genesis Paradisae->Порождение рая
Death from Above->Смерть свыше
Guardian of the Mound->Страж кургана
Alpha Paradisae->Райский вожак
Mother of the Swarm->Мать роя
Deathflutter->Смертоносец
Bladetooth->Сталезуб
Wrigglechaw->Пеленатель
Blinkflame->Мерцающий пламень
The Duchess->Матрона
Shivershell->Ледяной панцирь
Razorleaf->Страшный душитель
Stranglecreep->Медноклык
Pewterfang->Бледная вдова
Bladeback Guardian->Шипастый страж
Strangledrift->Парящий душитель
Ghostram->Призрачный таранщик
Risen Infested Beast->Остов заражённого зверя
Mutated Ursa->Мутировавший медведь
Mutated Watcher->Мутировавший смотритель
Mutated Broodqueen->Мутировавший вожак
Mutated Croaker->Мутировавший квакун
Mutated Arachnid->Мутировавший арахнид
Twisted Chimeral->Исковерканный ящер
Mutated Flamebeast->Мутировавший жарошкур
Mutated Winterclaw->Мутировавший хладокраб
Mutated Chieftain->Мутировавший вожак обезьян
Mutated Rhoa->Мутировавший роа
Mutated Adder->Мутировавший аспид
Mutated Maw->Мутировавшая пасть
The Hundred Foot Shadow->Стофутовая тень
Raihara, Tukohama's Loyal->Раихара, приверженец Тукохамы
Steelchaw->Стальной жевун
Eyepecker->Глазохват
Boulderback->Камнеспин
Mutewind Lynx->Рысь из Немого ветра
Echo of the Verdant->Эхо зелени
Echo of the Verdant->Эхо зелени
Blue Frog->Голубая лягушка
Common Frog->Обычная лягушка
Strange Frog->Странная лягушка
The Encephalophage->Энцефалофаг
Lola, the Fierce->Лола, Свирепая
Rocco, the Bloodthirsty->Рокко, Жаждущий крови
Brinecrack->Морской щелкун
Tamulus->Тамалус
Tamipin->Тамипин
The Basilisk->Василиск
Saqawine Rhex->Рекс Сакаваля
Saqawal, First of the Sky->Сакаваль, Первый Неба
Saqawine Rhoa->Роа Сакаваля
Saqawine Vulture->Гриф Сакаваля
Saqawine Retch->Рыгатель Сакаваля
Saqawine Cobra->Кобра Сакаваля
Saqawine Blood Viper->Кровавая гадюка Сакаваля
Saqawine Chimeral->Ящер Сакаваля
Farric Flame Hellion Alpha->Адский лев-альфа Фаррул
Farric Frost Hellion Alpha->Морозный адский лев Фаррул
Farric Lynx Alpha->Рысь-альфа Фаррул
Farric Tiger Alpha->Тигр-альфа Фаррул
Farrul, First of the Plains->Фаррул, Первая Равнин
Farric Wolf Alpha->Волк-альфа Фаррул
Craiceann, First of the Deep->Краценн, Первый Глубин
Fenumal Queen->Королева Фенумы
Fenumal Scrabbler->Норовик Фенумы
Fenumal Devourer->Пожиратель Фенумы
Fenumal Scorpion->Скорпион Фенумы
Fenumal Plagued Arachnid->Чумной арахнид Фенумы
Fenumal Hybrid Arachnid->Гибридный арахнид Фенумы
Fenumus, First of the Night->Фенума, Первая Ночи
Fenumal Widow->Вдова Фенумы
Farric Goliath->Исполин Фаррул
Farric Taurus->Телец Фаррул
Farric Chieftain->Вождь Фаррул
Farric Ape->Примат Фаррул
Farric Goatman->Козерог Фаррул
Farric Magma Hound->Магмовая гончая Фаррул
Farric Pit Hound->Подземная гончая Фаррул
Farric Gargantuan->Громадина Фаррул
Farric Ursa->Медведь Фаррул
Craicic Sand Spitter->Песчаный плевун Краценна
Craicic Shield Crab->Крепкий краб Краценна
Craicic Savage Crab->Свирепый краб Краценна
Craicic Spider Crab->Краб-паук Краценна
Craicic Maw->Пасть Краценна
Craicic Chimeral->Ящер Краценна
Craicic Vassal->Слуга Краценна
Craicic Squid->Кальмар Краценна
Craicic Watcher->Смотритель Краценна
The Black Mórrigan->Чернокрылая Морриган



Economy->Экономика
Fragments->Фрагменты
Name->Название
Value->Стоимость
Last 7 days->Последние 7 дней
Listed->Количество
Tier->Уровень
Buying price->Цена покупки
Selling price->Цена продажи
Buy->Купить
Sell->Продать
Not enough data->Недостаточно данных
Trade->Торговля
Tattoos->Татуировки