
//////////////////////////////// Скарабеи //////////////////////////////////
Scarabs->Скарабеи
Abyss Scarab->Abyss Scarab-(Скарабей Бездны)
Abyss Scarab of Edifice->Abyss Scarab of Edifice-(Скарабей Бездны строений)
Abyss Scarab of Emptiness->Abyss Scarab of Emptiness-(Скарабей Бездны пустоты)
Abyss Scarab of Multitudes->Abyss Scarab of Multitudes-(Скарабей Бездны множеств)
Abyss Scarab of Profound Depth->Abyss Scarab of Profound Depth-(Скарабей Засады)
Ambush Scarab->Ambush Scarab-(Скарабей Засады содержания)
Ambush Scarab of Containment->Ambush Scarab of Containment-(Скарабей Засады разборчивости)
Ambush Scarab of Discernment->Ambush Scarab of Discernment-(Скарабей Засады потайных отсеков)
Ambush Scarab of Hidden Compartments->Ambush Scarab of Hidden Compartments-(Скарабей Засады могущества)
Ambush Scarab of Potency->Ambush Scarab of Potency-(Скарабей Анархии)
Anarchy Scarab->Anarchy Scarab-(Скарабей Анархии исполинства)
Anarchy Scarab of Gigantification->Anarchy Scarab of Gigantification-(Скарабей Анархии партнёрства)
Anarchy Scarab of Partnership->Anarchy Scarab of Partnership-(Скарабей Бестиария)
Bestiary Scarab->Bestiary Scarab-(Скарабей Бестиария удвоения)
Bestiary Scarab of Duplicating->Bestiary Scarab of Duplicating-(Скарабей Бестиария стаи)
Bestiary Scarab of the Herd->Bestiary Scarab of the Herd-(Скарабей Бестиария тёмной вороны)
Bestiary Scarab of the Shadowed Crow->Bestiary Scarab of the Shadowed Crow-(Скарабей Предательства)
Betrayal Scarab->Betrayal Scarab-(Скарабей Предательства разведки)
Betrayal Scarab of Intelligence->Betrayal Scarab of Intelligence-(Скарабей Предательства увековечения)
Betrayal Scarab of Perpetuation->Betrayal Scarab of Perpetuation-(Скарабей Предательства подкреплений)
Betrayal Scarab of Reinforcements->Betrayal Scarab of Reinforcements-(Скарабей Иномирья)
Beyond Scarab->Beyond Scarab-(Скарабей Иномирья осквернения)
Beyond Scarab of Corruption->Beyond Scarab of Corruption-(Скарабей Иномирья кровопотери)
Beyond Scarab of Haemophilia->Beyond Scarab of Haemophilia-(Скарабей Иномирья возрождения)
Beyond Scarab of Resurgence->Beyond Scarab of Resurgence-(Скарабей Иномирья вторжения)
Beyond Scarab of the Invasion->Beyond Scarab of the Invasion-(Скарабей Скверны)
Blight Scarab->Blight Scarab-(Скарабей Скверны цветения)
Blight Scarab of Blooming->Blight Scarab of Blooming-(Скарабей Скверны щедрости)
Blight Scarab of Bounty->Blight Scarab of Bounty-(Скарабей Скверны масел)
Blight Scarab of Invigoration->Blight Scarab of Invigoration-(Скарабей Разлома)
Blight Scarab of Oils->Blight Scarab of Oils-(Скарабей Разлома владений)
Breach Scarab->Breach Scarab-(Скарабей Разлома ловушек)
Breach Scarab of Lordship->Breach Scarab of Lordship-(Скарабей Разлома расщепления)
Breach Scarab of Resonant Cascade->Breach Scarab of Resonant Cascade-(Скарабей Разлома мечтателя)
Breach Scarab of Snares->Breach Scarab of Snares-(Скарабей картографии)
Breach Scarab of Splintering->Breach Scarab of Splintering-(Скарабей картографии восхождения)
Breach Scarab of the Dreamer->Breach Scarab of the Dreamer-(Скарабей картографии осквернения)
Cartography Scarab->Cartography Scarab-(Скарабей картографии удвоения)
Cartography Scarab of Ascension->Cartography Scarab of Ascension-(Скарабей картографии неповторимости)
Cartography Scarab of Corruption->Cartography Scarab of Corruption-(Скарабей Делириума)
Cartography Scarab of Duplication->Cartography Scarab of Duplication-(Скарабей Делириума галлюцинаций)
Cartography Scarab of Singularity->Cartography Scarab of Singularity-(Скарабей Делириума мании)
Delirium Scarab->Delirium Scarab-(Скарабей Делириума неврозов)
Delirium Scarab of Delusions->Delirium Scarab of Delusions-(Скарабей Делириума паранойи)
Delirium Scarab of Mania->Delirium Scarab of Mania-(Скарабей предсказания)
Delirium Scarab of Neuroses->Delirium Scarab of Neuroses-(Скарабей предсказания завершения)
Delirium Scarab of Paranoia->Delirium Scarab of Paranoia-(Скарабей предсказания курирования)
Divination Scarab->Divination Scarab-(Скарабей Господства)
Divination Scarab of Completion->Divination Scarab of Completion-(Скарабей Господства аномалии)
Divination Scarab of Curation->Divination Scarab of Curation-(Скарабей Господства учений)
Domination Scarab->Domination Scarab-(Скарабей Господства ужасов)
Domination Scarab of Abnormality->Domination Scarab of Abnormality-(Скарабей Сущности)
Domination Scarab of Teachings->Domination Scarab of Teachings-(Скарабей Сущности восхождения)
Domination Scarab of Terrors->Domination Scarab of Terrors-(Скарабей Сущности окостенения)
Essence Scarab->Essence Scarab-(Скарабей Сущности стабильности)
Essence Scarab of Adaptation->Essence Scarab of Adaptation-(Скарабей Экспедиции)
Essence Scarab of Ascent->Essence Scarab of Ascent-(Скарабей Экспедиции археологии)
Essence Scarab of Calcification->Essence Scarab of Calcification-(Скарабей Экспедиции поиска рун)
Essence Scarab of Stability->Essence Scarab of Stability-(Скарабей Экспедиции скальда)
Expedition Scarab->Expedition Scarab-(Скарабей Экспедиции веризиевой пыли)
Expedition Scarab of Archaeology->Expedition Scarab of Archaeology-(Скарабей Предвестника)
Expedition Scarab of Runefinding->Expedition Scarab of Runefinding-(Скарабей Предвестника разборчивости)
Expedition Scarab of the Skald->Expedition Scarab of the Skald-(Скарабей Предвестника регентства)
Expedition Scarab of Verisium Powder->Expedition Scarab of Verisium Powder-(Скарабей Предвестника военных запасов)
Harbinger Scarab->Harbinger Scarab-(Скарабей Жатвы)
Harbinger Scarab of Discernment->Harbinger Scarab of Discernment-(Скарабей Жатвы изобилия)
Harbinger Scarab of Regency->Harbinger Scarab of Regency-(Скарабей Жатвы удвоения)
Harbinger Scarab of Warhoards->Harbinger Scarab of Warhoards-(Рогатый скарабей пробуждения)
Harvest Scarab->Harvest Scarab-(Рогатый скарабей Родословных)
Harvest Scarab of Cornucopia->Harvest Scarab of Cornucopia-(Рогатый скарабей переливов)
Harvest Scarab of Doubling->Harvest Scarab of Doubling-(Рогатый скарабей Немезиды)
Horned Scarab of Awakening->Horned Scarab of Awakening-(Рогатый скарабей Пандемониума)
Horned Scarab of Bloodlines->Horned Scarab of Bloodlines-(Рогатый скарабей сохранения)
Horned Scarab of Glittering->Horned Scarab of Glittering-(Рогатый скарабей традиций)
Horned Scarab of Nemeses->Horned Scarab of Nemeses-(Скарабей Вмешательства)
Horned Scarab of Pandemonium->Horned Scarab of Pandemonium-(Скарабей Вмешательства чемпионов)
Horned Scarab of Preservation->Horned Scarab of Preservation-(Скарабей Вмешательства вторжения)
Horned Scarab of Tradition->Horned Scarab of Tradition-(Скарабей Вмешательства хроник)
Incursion Scarab->Incursion Scarab-(Влиятельный скарабей превращения)
Incursion Scarab of Champions->Incursion Scarab of Champions-(Влиятельный скарабей орд)
Incursion Scarab of Invasion->Incursion Scarab of Invasion-(Влиятельный скарабей Древнего)
Incursion Scarab of Timelines->Incursion Scarab of Timelines-(Влиятельный скарабей Создателя)
Influencing Scarab of Conversion->Influencing Scarab of Conversion-(Скарабей Легиона)
Influencing Scarab of Hordes->Influencing Scarab of Hordes-(Скарабей Легиона командования)
Influencing Scarab of the Elder->Influencing Scarab of the Elder-(Скарабей Легиона вечной войны)
Influencing Scarab of the Shaper->Influencing Scarab of the Shaper-(Скарабей Легиона офицеров)
Legion Scarab->Legion Scarab-(Скарабей Легиона Сехемы)
Legion Scarab of Command->Legion Scarab of Command-(Загадочный скарабей)
Legion Scarab of Eternal Conflict->Legion Scarab of Eternal Conflict-(Реликтовый скарабей)
Legion Scarab of Officers->Legion Scarab of Officers-(Реликтовый скарабей повелителей)
Legion Scarab of The Sekhema->Legion Scarab of The Sekhema-(Реликтовый скарабей видения)
Mysterious Scarab->Mysterious Scarab-(Ритуальный скарабей изобилия)
Reliquary Scarab->Reliquary Scarab-(Ритуальный скарабей признания)
Reliquary Scarab of Overlords->Reliquary Scarab of Overlords-(Ритуальный скарабей избранности)
Reliquary Scarab of Vision->Reliquary Scarab of Vision-(Скарабей антагонистов)
Ritual Scarab of Abundance->Ritual Scarab of Abundance-(Скарабей затравленных предателей)
Ritual Scarab of Recognition->Ritual Scarab of Recognition-(Скарабей чудовищных поколений)
Ritual Scarab of Selectiveness->Ritual Scarab of Selectiveness-(Скарабей стабильности)
Scarab of Adversaries->Scarab of Adversaries-(Сульфитовый скарабей)
Scarab of Hunted Traitors->Scarab of Hunted Traitors-(Сульфитовый скарабей испарений)
Scarab of Monstrous Lineage->Scarab of Monstrous Lineage-(Сульфитовый скарабей алчности)
Scarab of Radiant Storms->Scarab of Radiant Storms-(Скарабей Мучения)
Scarab of Stability->Scarab of Stability-(Скарабей Мучения своеобразия)
Scarab of Wisps->Scarab of Wisps-(Скарабей Мучения освобождения)
Sulphite Scarab->Sulphite Scarab-(Скарабей Ультиматума)
Sulphite Scarab of Fumes->Sulphite Scarab of Fumes-(Скарабей Ультиматума подкупа)
Sulphite Scarab of Greed->Sulphite Scarab of Greed-(Скарабей Ультиматума катализа)
Torment Scarab->Torment Scarab-(Скарабей Ультиматума поединка)
Torment Scarab of Peculiarity->Torment Scarab of Peculiarity-(Скарабей Ультиматума начертания)
Torment Scarab of Possession->Torment Scarab of Possession-(Скрытый скарабей  )
Torment Scarab of Release->Torment Scarab of Release-(Скарабей создания  )
Ultimatum Scarab->Ultimatum Scarab-(Скарабей тени  )
Ultimatum Scarab of Bribing->Ultimatum Scarab of Bribing-(Скарабей покровительства  )
Ultimatum Scarab of Catalysing->Ultimatum Scarab of Catalysing-(Скарабей зла  )
Ultimatum Scarab of Dueling->Ultimatum Scarab of Dueling-(Скарабей ярости  )
Ultimatum Scarab of Inscription->Ultimatum Scarab of Inscription-(Скарабей безумия  )
Veiled Scarab->Veiled Scarab-(Скарабей архетипов  )








//////////////////////////////// Камни умений //////////////////////////////////
Skill Gems->Камни умений
Cleave->Cleave-(Рассечение)
Cleave of Rage->Cleave of Rage-(Рассечение свирепости)
Glacial Hammer->Glacial Hammer-(Леденящий молот)
Glacial Hammer of Shattering->Glacial Hammer of Shattering-(Леденящий молот разбивания)
Ground Slam->Ground Slam-(Сотрясение)
Ground Slam of Earthshaking->Ground Slam of Earthshaking-(Сотрясение земли)
Heavy Strike->Heavy Strike-(Тяжёлый удар)
Molten Strike->Molten Strike-(Магмовый удар)
Molten Strike of the Zenith->Molten Strike of the Zenith-(Магмовый удар зенита)
Perforate->Perforate-(Пронзающие шипы)
Perforate of Duality->Perforate of Duality-(Пронзающие шипы двойственности)
Perforate of Bloodshed->Perforate of Bloodshed-(Пронзающие шипы резни)
Shield Crush->Shield Crush-(Сокрушающий щит)
Shield Crush of the Chieftain->Shield Crush of the Chieftain-(Сокрушающий щит вождя)
Smite->Smite-(Кара)
Smite of Divine Judgement->Smite of Divine Judgement-(Кара божественного правосудия)
Vaal Cleave->Vaal Cleave-(Рассечение ваал)
Vaal Glacial Hammer->Vaal Glacial Hammer-(Леденящий молот ваал)
Vaal Ground Slam->Vaal Ground Slam-(Сотрясение ваал)
Vaal Molten Strike->Vaal Molten Strike-(Магмовый удар ваал)
Vaal Smite->Vaal Smite-(Кара ваал)
Blood and Sand->Blood and Sand-(Кровь и песок)
Decoy Totem->Decoy Totem-(Тотем-приманка)
Devouring Totem->Devouring Totem-(Поглощающий тотем)
Holy Flame Totem->Holy Flame Totem-(Тотем священного огня)
Holy Flame Totem of Ire->Holy Flame Totem of Ire-(Гневный тотем священного огня)
Ancestral Protector->Ancestral Protector-(Защитник предков)
Molten Shell->Molten Shell-(Расплавленный панцирь)
Reckoning->Reckoning-(Возмездие)
Rejuvenation Totem->Rejuvenation Totem-(Восполняющий тотем)
Steelskin->Steelskin-(Стальная кожа)
Vaal Molten Shell->Vaal Molten Shell-(Расплавленный панцирь ваал)
Vaal Rejuvenation Totem->Vaal Rejuvenation Totem-(Восполняющий тотем ваал)
Vigilant Strike->Vigilant Strike-(Расчётливый удар)
War Banner->War Banner-(Знамя войны)
Enduring Cry->Enduring Cry-(Клич стойкости)
Intimidating Cry->Intimidating Cry-(Устрашающий клич)
Leap Slam->Leap Slam-(Наскок)
Leap Slam of Groundbreaking->Leap Slam of Groundbreaking-(Наскок сотрясения)
Shield Charge->Shield Charge-(Удар щитом)
Vitality->Vitality-(Живучесть)
Absolution->Absolution-(Отпущение)
Absolution of Inspiring->Absolution of Inspiring-(Отпущение вдохновения)
Chain Hook->Chain Hook-(Цепной крюк)
Earthshatter->Earthshatter-(Разлом земли)
Earthshatter of Fragility->Earthshatter of Fragility-(Разлом земли хрупкости)
Earthshatter of Prominence->Earthshatter of Prominence-(Разлом земли влияния)
Exsanguinate->Exsanguinate-(Обескровливание)
Exsanguinate of Transmission->Exsanguinate of Transmission-(Заражающее обескровливание)
Infernal Blow->Infernal Blow-(Удар преисподней)
Infernal Blow of Immolation->Infernal Blow of Immolation-(Удар преисподней самосожжения)
Searing Bond->Searing Bond-(Обжигающие узы)
Static Strike->Static Strike-(Статичный разряд)
Sunder->Sunder-(Раскол)
Sunder of Earthbreaking->Sunder of Earthbreaking-(Сокрушающий раскол)
Sweep->Sweep-(Круговой взмах)
Vaal Absolution->Vaal Absolution-(Отпущение ваал)
Vaal Volcanic Fissure->Vaal Volcanic Fissure-(Вулканический разлом ваал)
Volcanic Fissure->Volcanic Fissure-(Вулканический разлом)
Volcanic Fissure of Snaking->Volcanic Fissure of Snaking-(Вулканический разлом зигзагов)
Ancestral Cry->Ancestral Cry-(Клич предков)
Corrupting Fever->Corrupting Fever-(Разлагающая лихорадка)
Defiance Banner->Defiance Banner-(Знамя непокорности)
Flesh and Stone->Flesh and Stone-(Камень и плоть)
Herald of Ash->Herald of Ash-(Вестник пепла)
Herald of Purity->Herald of Purity-(Вестник чистоты)
Seismic Cry->Seismic Cry-(Сейсмический клич)
Warlord's Mark->Warlord's Mark-(Метка вождя)
Infernal Cry->Infernal Cry-(Клич преисподней)
Anger->Anger-(Жгучая злоба)
Battlemage's Cry->Battlemage's Cry-(Клич боевого мага)
Call to Arms->Call to Arms-(Призыв к оружию)
Determination->Determination-(Решимость)
Dread Banner->Dread Banner-(Знамя страха)
Purity of Fire->Purity of Fire-(Спасение от огня)
General's Cry->General's Cry-(Клич полководца)
Vulnerability->Vulnerability-(Беззащитность)
Petrified Blood->Petrified Blood-(Окаменелая кровь)
Pride->Pride-(Гордость)
Punishment->Punishment-(Наказание)
Rallying Cry->Rallying Cry-(Клич сплочения)
Vaal Impurity of Fire->Vaal Impurity of Fire-(Погибель от огня ваал)
Vengeance->Vengeance-(Отмщение)
Ancestral Warchief->Ancestral Warchief-(Вождь предков)
Animate Guardian->Animate Guardian-(Аниматрон)
Animate Guardian of Smiting->Animate Guardian of Smiting-(Аниматрон кары)
Bladestorm->Bladestorm-(Ураган лезвий)
Bladestorm of Uncertainty->Bladestorm of Uncertainty-(Ураган лезвий неопределённости)
Reap->Reap-(Кровавая жатва)
Boneshatter->Boneshatter-(Дробление костей)
Boneshatter of Complex Trauma->Boneshatter of Complex Trauma-(Дробление костей сложного перелома)
Boneshatter of Carnage->Boneshatter of Carnage-(Дробление костей бойни)
Consecrated Path->Consecrated Path-(Освящённый путь)
Consecrated Path of Endurance->Consecrated Path of Endurance-(Освящённый путь выносливости)
Dominating Blow->Dominating Blow-(Удар власти)
Dominating Blow of Inspiring->Dominating Blow of Inspiring-(Удар власти вдохновения)
Earthquake->Earthquake-(Землетрясение)
Earthquake of Amplification->Earthquake of Amplification-(Землетрясение усиления)
Ice Crash->Ice Crash-(Ледяное сокрушение)
Ice Crash of Cadence->Ice Crash of Cadence-(Ритмичное ледяное сокрушение)
Rage Vortex->Rage Vortex-(Свирепый вихрь)
Rage Vortex of Berserking->Rage Vortex of Berserking-(Свирепый вихрь неистовства)
Shockwave Totem->Shockwave Totem-(Сотрясающий тотем)
Tectonic Slam->Tectonic Slam-(Тектонический удар)
Tectonic Slam of Cataclysm->Tectonic Slam of Cataclysm-(Тектонический удар катаклизма)
Vaal Ancestral Warchief->Vaal Ancestral Warchief-(Вождь предков ваал)
Vaal Domination->Vaal Domination-(Господство ваал)
Vaal Earthquake->Vaal Earthquake-(Землетрясение ваал)
Vaal Reap->Vaal Reap-(Кровавая жатва ваал)
Berserk->Berserk-(Боевого безумие)
Flame Link->Flame Link-(Пламенная связь)
Frozen Legion->Frozen Legion-(Замёрзший легион)
Frozen Legion of Rallying->Frozen Legion of Rallying-(Замёрзший легион сплочения)
Immortal Call->Immortal Call-(Призыв к бессмертию)
Protective Link->Protective Link-(Ограждающая связь)
Summon Flame Golem->Summon Flame Golem-(Призыв голема огня)
Summon Flame Golem of Hordes->Summon Flame Golem of Hordes-(Призыв голема огня орды)
Summon Flame Golem of the Meteor->Summon Flame Golem of the Meteor-(Призыв голема огня метеора)
Summon Stone Golem->Summon Stone Golem-(Призыв каменного голема)
Summon Stone Golem of Hordes->Summon Stone Golem of Hordes-(Призыв каменного голема орды)
Summon Stone Golem of Safeguarding->Summon Stone Golem of Safeguarding-(Призыв каменного голема охраны)
Vaal Immortal Call->Vaal Immortal Call-(Призыв к бессмертию ваал)
Burning Arrow->Burning Arrow-(Горящая стрела)
Burning Arrow of Vigour->Burning Arrow of Vigour-(Горящая стрела мощи)
Cobra Lash->Cobra Lash-(Бросок кобры)
Double Strike->Double Strike-(Двойной удар)
Double Strike of Impaling->Double Strike of Impaling-(Двойной удар прокола)
Double Strike of Momentum->Double Strike of Momentum-(Двойной удар импульса)
Dual Strike->Dual Strike-(Парный удар)
Dual Strike of Ambidexterity->Dual Strike of Ambidexterity-(Парный удар амбидекстрии)
Ethereal Knives->Ethereal Knives-(Бесплотные ножи)
Ethereal Knives of Lingering Blades->Ethereal Knives of Lingering Blades-(Бесплотные ножи остаточных клинков)
Ethereal Knives of the Massacre->Ethereal Knives of the Massacre-(Бесплотные ножи резни)
Frost Blades->Frost Blades-(Ледяные клинки)
Frost Blades of Katabasis->Frost Blades of Katabasis-(Ледяные клинки катабасиса)
Ice Shot->Ice Shot-(Ледяной выстрел)
Ice Shot of Penetration->Ice Shot of Penetration-(Ледяной выстрел пронзания)
Caustic Arrow->Caustic Arrow-(Едкая стрела)
Caustic Arrow of Poison->Caustic Arrow of Poison-(Едкая стрела яда)
Galvanic Arrow->Galvanic Arrow-(Электризующая стрела)
Galvanic Arrow of Energy->Galvanic Arrow of Energy-(Электризующая стрела энергии)
Galvanic Arrow of Surging->Galvanic Arrow of Surging-(Бушующая электризующая стрела)
Explosive Trap->Explosive Trap-(Взрывная ловушка)
Explosive Trap of Shrapnel->Explosive Trap of Shrapnel-(Взрывная ловушка осколков)
Explosive Trap of Magnitude->Explosive Trap of Magnitude-(Взрывная ловушка интенсивности)
Split Arrow->Split Arrow-(Расколотая стрела)
Split Arrow of Splitting->Split Arrow of Splitting-(Расколотая стрела раскалывания)
Splitting Steel->Splitting Steel-(Раскалывающая сталь)
Splitting Steel of Ammunition->Splitting Steel of Ammunition-(Раскалывающая сталь боезапаса)
Spectral Throw->Spectral Throw-(Призрачный бросок)
Spectral Throw of Materialising->Spectral Throw of Materialising-(Призрачный бросок воплощения)
Vaal Burning Arrow->Vaal Burning Arrow-(Горящая стрела ваал)
Vaal Caustic Arrow->Vaal Caustic Arrow-(Едкая стрела ваал)
Vaal Double Strike->Vaal Double Strike-(Двойной удар ваал)
Vaal Ice Shot->Vaal Ice Shot-(Ледяной выстрел ваал)
Vaal Spectral Throw->Vaal Spectral Throw-(Призрачный бросок ваал)
Viper Strike->Viper Strike-(Удар гадюки)
Viper Strike of the Mamba->Viper Strike of the Mamba-(Удар гадюки Мамбы)
Animate Weapon->Animate Weapon-(Живое оружие)
Animate Weapon of Self Reflection->Animate Weapon of Self Reflection-(Живое оружие отражения)
Animate Weapon of Ranged Arms->Animate Weapon of Ranged Arms-(Живое оружие дальнего боя)
Bear Trap->Bear Trap-(Медвежий капкан)
Bear Trap of Skewers->Bear Trap of Skewers-(Медвежий капкан пронзения)
Dash->Dash-(Рывок)
Detonate Dead->Detonate Dead-(Подрыв трупа)
Detonate Dead of Scavenging->Detonate Dead of Scavenging-(Подрыв трупа поглощения)
Detonate Dead of Chain Reaction->Detonate Dead of Chain Reaction-(Подрыв трупа цепной реакции)
Sniper's Mark->Sniper's Mark-(Метка снайпера)
Puncture->Puncture-(Надрез)
Riposte->Riposte-(Парирование)
Shrapnel Ballista->Shrapnel Ballista-(Осколочная баллиста)
Shrapnel Ballista of Steel->Shrapnel Ballista of Steel-(Стальная осколочная баллиста)
Vaal Animate Weapon->Vaal Animate Weapon-(Живое оружие ваал)
Vaal Detonate Dead->Vaal Detonate Dead-(Подрыв трупа ваал)
Blink Arrow->Blink Arrow-(Стрела-телепорт)
Blink Arrow of Bombarding Clones->Blink Arrow of Bombarding Clones-(Стрела-телепорт бомбардирующих клонов)
Blink Arrow of Prismatic Clones->Blink Arrow of Prismatic Clones-(Стрела-телепорт радужных клонов)
Unearth->Unearth-(Эксгумация)
Flicker Strike->Flicker Strike-(Внезапный удар)
Flicker Strike of Power->Flicker Strike of Power-(Внезапный удар энергии)
Mirror Arrow->Mirror Arrow-(Стрела-двойник)
Mirror Arrow of Bombarding Clones->Mirror Arrow of Bombarding Clones-(Стрела-двойник бомбардирующих клонов)
Mirror Arrow of Prismatic Clones->Mirror Arrow of Prismatic Clones-(Стрела-двойник радужных клонов)
Precision->Precision-(Точность)
Smoke Mine->Smoke Mine-(Дымовая мина)
Vaal Flicker Strike->Vaal Flicker Strike-(Внезапный удар ваал)
Whirling Blades->Whirling Blades-(Шквал клинков)
Withering Step->Withering Step-(Губительный шаг)
Barrage->Barrage-(Очередь)
Barrage of Volley Fire->Barrage of Volley Fire-(Очередь залпов)
Blade Trap->Blade Trap-(Ловушка лезвий)
Blade Trap of Greatswords->Blade Trap of Greatswords-(Ловушка лезвий с большими мечами)
Blade Trap of Laceration->Blade Trap of Laceration-(Ловушка лезвий разрубания)
Blade Vortex->Blade Vortex-(Вихрь клинков)
Blade Vortex of the Scythe->Blade Vortex of the Scythe-(Вихрь клинков косы)
Elemental Hit->Elemental Hit-(Удар стихии)
Elemental Hit of the Spectrum->Elemental Hit of the Spectrum-(Спектральный удар стихии)
Fire Trap->Fire Trap-(Огненная ловушка)
Fire Trap of Blasting->Fire Trap of Blasting-(Огненная ловушка взрывов)
Lacerate->Lacerate-(Разрубание)
Lacerate of Butchering->Lacerate of Butchering-(Разрубание туш)
Lacerate of Haemorrhage->Lacerate of Haemorrhage-(Разрубание кровоизлияния)
Lightning Arrow->Lightning Arrow-(Стрела молнии)
Lightning Arrow of Electrocution->Lightning Arrow of Electrocution-(Стрела молнии проводимости)
Lightning Strike->Lightning Strike-(Удар молнии)
Lightning Strike of Arcing->Lightning Strike of Arcing-(Удар цепной молнии)
Poisonous Concoction->Poisonous Concoction-(Ядовитая смесь)
Poisonous Concoction of Bouncing->Poisonous Concoction of Bouncing-(Отскакивающая ядовитая смесь)
Rain of Arrows->Rain of Arrows-(Ливень стрел)
Rain of Arrows of Artillery->Rain of Arrows of Artillery-(Артиллерийский ливень стрел)
Rain of Arrows of Saturation->Rain of Arrows of Saturation-(Ливень стрел насыщения)
Reave->Reave-(Опустошение)
Reave of Refraction->Reave of Refraction-(Преломляющее опустошение)
Shattering Steel->Shattering Steel-(Дробящая сталь)
Shattering Steel of Ammunition->Shattering Steel of Ammunition-(Дробящая сталь боезапаса)
Siege Ballista->Siege Ballista-(Осадная баллиста)
Siege Ballista of Splintering->Siege Ballista of Splintering-(Осадная баллиста осколков)
Spectral Helix->Spectral Helix-(Призрачная спираль)
Toxic Rain->Toxic Rain-(Токсичный дождь)
Toxic Rain of Sporeburst->Toxic Rain of Sporeburst-(Токсичный дождь выброса спор)
Toxic Rain of Withering->Toxic Rain of Withering-(Токсичный дождь увядания)
Vaal Blade Vortex->Vaal Blade Vortex-(Вихрь клинков ваал)
Vaal Lightning Arrow->Vaal Lightning Arrow-(Стрела молнии ваал)
Vaal Lightning Strike->Vaal Lightning Strike-(Удар молнии ваал)
Vaal Rain of Arrows->Vaal Rain of Arrows-(Ливень стрел ваал)
Vaal Reave->Vaal Reave-(Опустошение ваал)
Vaal Venom Gyre->Vaal Venom Gyre-(Круг яда ваал)
Venom Gyre->Venom Gyre-(Круг яда)
Volatile Dead->Volatile Dead-(Нестабильный труп)
Volatile Dead of Confinement->Volatile Dead of Confinement-(Заточенный нестабильный труп)
Volatile Dead of Seething->Volatile Dead of Seething-(Бурлящий нестабильный труп)
Arctic Armour->Arctic Armour-(Северная броня)
Blade Blast->Blade Blast-(Взрыв клинков)
Blade Blast of Unloading->Blade Blast of Unloading-(Взрыв клинков разрядки)
Blade Blast of Dagger Detonation->Blade Blast of Dagger Detonation-(Взрыв клинков кинжалов)
Blood Rage->Blood Rage-(Кровавый угар)
Desecrate->Desecrate-(Осквернение)
Ensnaring Arrow->Ensnaring Arrow-(Стрела ловчего)
Frenzy->Frenzy-(Бешенство)
Frenzy of Onslaught->Frenzy of Onslaught-(Бешенство боевого ража)
Herald of Agony->Herald of Agony-(Вестник агонии)
Herald of Ice->Herald of Ice-(Вестник льда)
Poacher's Mark->Poacher's Mark-(Метка браконьера)
Vaal Arctic Armour->Vaal Arctic Armour-(Северная броня ваал)
Alchemist's Mark->Alchemist's Mark-(Метка алхимика)
Purity of Ice->Purity of Ice-(Спасение от холода)
Grace->Grace-(Грация)
Haste->Haste-(Спешка)
Hatred->Hatred-(Холодная ненависть)
Plague Bearer->Plague Bearer-(Носитель чумы)
Temporal Chains->Temporal Chains-(Путы времени)
Vaal Impurity of Ice->Vaal Impurity of Ice-(Погибель от холода ваал)
Vaal Grace->Vaal Grace-(Грация ваал)
Vaal Haste->Vaal Haste-(Спешка ваал)
Artillery Ballista->Artillery Ballista-(Артиллерийская баллиста)
Artillery Ballista of Cross Strafe->Artillery Ballista of Cross Strafe-(Артиллерийская баллиста перекрестного огня)
Artillery Ballista of Focus Fire->Artillery Ballista of Focus Fire-(Артиллерийская баллиста прицельного огня)
Bladefall->Bladefall-(Мечепад)
Bladefall of Volleys->Bladefall of Volleys-(Мечепад града)
Bladefall of Impaling->Bladefall of Impaling-(Мечепад пронзания)
Blast Rain->Blast Rain-(Дождь взрывов)
Blade Flurry->Blade Flurry-(Порыв клинков)
Blade Flurry of Incision->Blade Flurry of Incision-(Порыв клинков надреза)
Charged Dash->Charged Dash-(Заряженный рывок)
Cremation->Cremation-(Кремация)
Cremation of Exhuming->Cremation of Exhuming-(Кремация эксгумации)
Cremation of the Volcano->Cremation of the Volcano-(Кремация вулкана)
Cyclone->Cyclone-(Вихрь)
Cyclone of Tumult->Cyclone of Tumult-(Вихрь буйства)
Explosive Arrow->Explosive Arrow-(Взрывная стрела)
Explosive Concoction->Explosive Concoction-(Взрывная смесь)
Explosive Concoction of Destruction->Explosive Concoction of Destruction-(Взрывная смесь разрушения)
Flamethrower Trap->Flamethrower Trap-(Ловушка-огнемёт)
Ice Trap->Ice Trap-(Ледяная ловушка)
Ice Trap of Hollowness->Ice Trap of Hollowness-(Ледяная ловушка пустоты)
Lancing Steel->Lancing Steel-(Пронзающая сталь)
Lancing Steel of Spraying->Lancing Steel of Spraying-(Пронзающая сталь разброса)
Pestilent Strike->Pestilent Strike-(Моровой удар)
Seismic Trap->Seismic Trap-(Сейсмическая ловушка)
Seismic Trap of Swells->Seismic Trap of Swells-(Сейсмическая ловушка волн)
Scourge Arrow->Scourge Arrow-(Стрела скверны)
Scourge Arrow of Menace->Scourge Arrow of Menace-(Стрела скверны угрозы)
Storm Rain->Storm Rain-(Грозовой дождь)
Storm Rain of the Conduit->Storm Rain of the Conduit-(Грозовой дождь проводника)
Storm Rain of the Fence->Storm Rain of the Fence-(Заградительный грозовой дождь)
Spectral Shield Throw->Spectral Shield Throw-(Бросок призрачного щита)
Spectral Shield Throw of Shattering->Spectral Shield Throw of Shattering-(Призрачный бросок щита разбивания)
Tornado Shot->Tornado Shot-(Вихрь стрел)
Tornado Shot of Cloudburst->Tornado Shot of Cloudburst-(Вихрь стрел раскатов)
Vaal Blade Flurry->Vaal Blade Flurry-(Порыв клинков ваал)
Vaal Cyclone->Vaal Cyclone-(Вихрь ваал)
Wild Strike->Wild Strike-(Шальной удар)
Wild Strike of Extremes->Wild Strike of Extremes-(Шальной удар полярности)
Ambush->Ambush-(Задача)
Snipe->Snipe-(Прицельный выстрел)
Intuitive Link->Intuitive Link-(Подсознательная связь)
Phase Run->Phase Run-(Призрачный бег)
Summon Ice Golem->Summon Ice Golem-(Призыв голема льда)
Summon Ice Golem of Hordes->Summon Ice Golem of Hordes-(Призыв голема льда орды)
Summon Ice Golem of Shattering->Summon Ice Golem of Shattering-(Призыв голема льда разбивания)
Temporal Rift->Temporal Rift-(Временной разрыв)
Tornado->Tornado-(Торнадо)
Tornado of Elemental Turbulence->Tornado of Elemental Turbulence-(Торнадо стихийной хаотичности)
Vampiric Link->Vampiric Link-(Иссушающая связь)
Lightning Tendril->Lightning Tendril-(Кровавый дождь)
Ice Spear->Ice Spear-(Переплетение)
Fireball->Fireball-(Пылающий поток)
Flame Surge->Flame Surge-(Искажённый удар)
Wintertide->Wintertide-(Ледяной шип)
Frost Nova->Frost Nova-(Цепь молний)
Plasma Geyser->Plasma Geyser-(Некротица)
Chain Lightning->Chain Lightning-(Ураган)
Shockwave->Shockwave-(Лунный свет)
Blazing Barrage->Blazing Barrage-(Ледяное дыхание)
Emberstorm->Emberstorm-(Ослепляющий свет)
Soul Siphon->Soul Siphon-(Сила бурь)
Blood Orb->Blood Orb-(Защитный круг)
Area Overload->Area Overload-(Ядовитая пыль)
Flame Burst->Flame Burst-(Тёмная завеса)
Flash Freeze->Flash Freeze-(Пламя боли)
Arcane Surge->Arcane Surge-(Стрела смерти)
Firestorm->Firestorm-(Жалящий удар)
Black Hole->Black Hole-(Восстановление)
Spirit Barrier->Spirit Barrier-(Очищение)
Raging Inferno->Raging Inferno-(Песчаный шторм)
Astral Projection->Astral Projection-(Обманчивый свет)
Elemental Armor->Elemental Armor-(Проклятие)
Shield of Valor->Shield of Valor-(Ветер перемен)
Icy Veins->Icy Veins-(Ярость)
Arcane Fire->Arcane Fire-(Поражение)
Arcane Shield->Arcane Shield-(Уничтожение)
Randomizer->Randomizer-(Небесное величие)
Echoing Null->Echoing Null-(Слепящая тьма)
Frigid Spikes->Frigid Spikes-(Рывок)
Burning Surge->Burning Surge-(Ловкость)
Tidal Wave->Tidal Wave-(Устойчивость)
Starfall->Starfall-(Печать)
Radiant Beam->Radiant Beam-(Обсидиановая парча)
Arcane Blast->Arcane Blast-(Рвущая стена)
Silencing Wave->Silencing Wave-(Призрачная тень)
Bouncing Blast->Bouncing Blast-(Ледяной кошмар)
Runic Shield->Runic Shield-(Ураган огня)
Fiery Chains->Fiery Chains-(Мыслительная связь)
Ice Barrier->Ice Barrier-(Тоннель)
Summoning Ray->Summoning Ray-(Лунная пыль)
Elemental Shield->Elemental Shield-(Сила света)
Time Warp->Time Warp-(Ограничение)
Glacial Field->Glacial Field-(Первая капля)
Electroshock->Electroshock-(Разрушитель)
Searing Wave->Searing Wave-(Яркий луч)
Vacuum Aura->Vacuum Aura-(Отражение)
Beacon of Light->Beacon of Light-(Ледяная преграда)
Shock Strike->Shock Strike-(Пламенный след)
Oppressive Force->Oppressive Force-(Клинок правосудия)
Helios Beam->Helios Beam-(Ослепляющий удар)
Plague Wave->Plague Wave-(Вечный огонь)
Demonic Helix->Demonic Helix-(Зов)
Shadow Bolt->Shadow Bolt-(Мыслительная проекция)
Serpent's Grasp->Serpent's Grasp-(Искра хаоса)
Ethereal Chains->Ethereal Chains-(Разделение)
Mystic Flames->Mystic Flames-(Образ бури)
Hydromancer's Call->Hydromancer's Call-(Забвение)
Fiery Gauntlet->Fiery Gauntlet-(Ледяная смерть)
Warding Shield->Warding Shield-(Проклятие скверны)
Arcane Chains->Arcane Chains-(Удар Молнии)
Shadow Cloak->Shadow Cloak-(Зов сокрытой силы)
Storm Shield->Storm Shield-(Небесное воробей)
Torrent->Torrent-(Буря)
Healing Beam->Healing Beam-(Стихийный взрыв)
Ethereal Blades->Ethereal Blades-(Глубокое пробуждение)
Blinding Radiance->Blinding Radiance-(Удары земли)
Infernal Web->Infernal Web-(Удар мракобесия)
Celestial Grasp->Celestial Grasp-(Призрак света)
Healing Ward->Healing Ward-(Прощение)
Hailstorm->Hailstorm-(Ледяное пробуждение)
Flickering Flash->Flickering Flash-(Крик природы)
Resonance->Resonance-(Темный поток)
Soul Harvest->Soul Harvest-(Оборона)
Fractured Light->Fractured Light-(Небесная тень)
Moonbeam->Moonbeam-(Древний взрыв)
Echo Chamber->Echo Chamber-(Проклятие хаоса)
Sinister Whispers->Sinister Whispers-(Обход)
Tidal Surge->Tidal Surge-(Призрачный блеск)
Stone Skin->Stone Skin-(Пламя)
Empowering Ring->Empowering Ring-(Ядовитый взрыв)
Heat Wave->Heat Wave-(Светлый взгляд)
Arcane Mirage->Arcane Mirage-(Солнечное затмение)
Liquid Fire->Liquid Fire-(Опустошение)
Tornado Strike->Tornado Strike-(Волшебный щит)
Rage Burst->Rage Burst-(Жрецы света)
Searing Chains->Searing Chains-(Печать ярости)
Warding Aura->Warding Aura-(Мгла)
Mystic Shield->Mystic Shield-(Люция)
Ice Shield->Ice Shield-(Огненная струя)
Elemental Explosion->Elemental Explosion-(Обездвиживание)
Stalwart Bulwark->Stalwart Bulwark-(Путешествие)
Twisting Phantasm->Twisting Phantasm-(Носитель иллюзий)
Nightmare Realm->Nightmare Realm-(Татарин)
Ethereal Flame->Ethereal Flame-(Снегопад)
Luminous Wave->Luminous Wave-(Сингулярность)
Chaos Shield->Chaos Shield-(Истребление)
Blade Fury->Blade Fury-(Исцеление)
Burning Ash->Burning Ash-(Буря стихий)
Celestial Flash->Celestial Flash-(Пылающий штык)
Time Distortion->Time Distortion-(Наступление)
Frostbite->Frostbite-(Сырое время)
Ebon Shields->Ebon Shields-(Небо)
Gale Winds->Gale Winds-(Гладь)
Whispering Shadows->Whispering Shadows-(Погружение)
Draining Pulse->Draining Pulse-(Изгнание)
Mystic Circle->Mystic Circle-(Метаморфозы)
Ice Fortress->Ice Fortress-(Тьма)
Cleansing Rain->Cleansing Rain-(Песок)
Frozen Shield->Frozen Shield-(Равнина)
Whirling Storm->Whirling Storm-(Бурьян)
Celestial Song->Celestial Song-(Ярость природы)
Ensnaring Strike->Ensnaring Strike-(Свет)
Ice Blight->Ice Blight-(Истребить)
Astral Shield->Astral Shield-(Уничтожить)
Fateful Blow->Fateful Blow-(Счастье)
Volatile Breath->Volatile Breath-(Перемена)
Fractured Sphere->Fractured Sphere-(Нападение)
Mystic Blast->Mystic Blast-(Прощение)
Shear Storm->Shear Storm-(Поразить)
Vaporous Step->Vaporous Step-(Силы тьмы)
Shadow Surge->Shadow Surge-(Очистка)
Arcane Leap->Arcane Leap-(Смятение)
Pulsing Surge->Pulsing Surge-(Тишина)
Ethereal Burst->Ethereal Burst-(Крик волка)
Storm Scourge->Storm Scourge-(Небесная фурия)
Frosty Gale->Frosty Gale-(Откровение)
Pyromancer's Call->Pyromancer's Call-(Первая воля)
Radiant Echo->Radiant Echo-(Последствия)
Blazing Chain->Blazing Chain-(Временами)
Searing Elixir->Searing Elixir-(Усыновление)
Soul Fire->Soul Fire-(Эпопея)
Ethereal Flight->Ethereal Flight-(Ураган могущества)
Flame Rush->Flame Rush-(Направление)
Shadow Dance->Shadow Dance-(Зов)
Froststorm->Froststorm-(Некромантия)
Arcane Torrent->Arcane Torrent-(Тайный путь)
Steadfast Arrow->Steadfast Arrow-(Наказание)
Gale Blade->Gale Blade-(Взрыв)
Mystic Rain->Mystic Rain-(Печать стихий)
Icy Breath->Icy Breath-(Сумрак)
Draining Shadow->Draining Shadow-(Нападение тьмы)
Shadow Miasma->Shadow Miasma-(Тёмный свет)
Ebon Wave->Ebon Wave-(Лунный удар)
Flame Burst->Flame Burst-(Ледяной удар)
Ethereal Cage->Ethereal Cage-(Проклятие сокрушения)
Shadow Prism->Shadow Prism-(Страдание)
Frost Cloak->Frost Cloak-(Ветры войны)
Echo Mirage->Echo Mirage-(Священные вершины)
Glacial Veil->Glacial Veil-(Разгром)
Stormfront->Stormfront-(Торжество)
Frost Shard->Frost Shard-(Переплетение)
Twisting Chain->Twisting Chain-(Песня)
Mystic Whispers->Mystic Whispers-(Признание)
Celestial Charge->Celestial Charge-(Конец света)
Inferno Blast->Inferno Blast-(Странствия)
Searing Flare->Searing Flare-(Долг)
Poisoned Blade->Poisoned Blade-(Ясность)
Elemental Fury->Elemental Fury-(Странник)
Shattering Wave->Shattering Wave-(Удары)
Shadow Spiral->Shadow Spiral-(Оживление)
Ethereal Scream->Ethereal Scream-(Паутина)
Frigid Grasp->Frigid Grasp-(Восхождение)
Soul Bind->Soul Bind-(Перемены)
Night Stalker->Night Stalker-(Глубь)
Time Shatter->Time Shatter-(Призыв)
Unholy Blade->Unholy Blade-(Стрелы)
Scorching Ray->Scorching Ray-(Устойчивый)
Shattered Light->Shattered Light-(Человек-тень)
Cyclone Strike->Cyclone Strike-(Блуждание)
Arcane Slumber->Arcane Slumber-(Будущее)
Flame Offense->Flame Offense-(Наказание)
Icy Grasp->Icy Grasp-(Укрепление)
Purifying Light->Purifying Light-(Череда)
Geyser->Geyser-(Подсказка)
Ethereal Glow->Ethereal Glow-(Ярость)
Storm Servant->Storm Servant-(Погружение)
Celestial Flare->Celestial Flare-(Тьма)
Rays of Light->Rays of Light-(Мглистый)
Frost Bite->Frost Bite-(Грех)
Healing Circle->Healing Circle-(Панда)
Mystic Light->Mystic Light-(Игра)
Radiant Shield->Radiant Shield-(Светлая)
Mystic Shard->Mystic Shard-(Исчерпание)
Ebon Gale->Ebon Gale-(Наступление)
Arcane Grasp->Arcane Grasp-(Укрытие)
Emberstorm->Emberstorm-(Исцеление)
Shadows of Time->Shadows of Time-(Призыв)
Frigid Chain->Frigid Chain-(Опасность)
Burning Fury->Burning Fury-(Непогода)
Stormcloud->Stormcloud-(Партнёр)
Ethereal Wave->Ethereal Wave-(Разметка)
Arcane Rift->Arcane Rift-(Прощение)
Frozen Vortex->Frozen Vortex-(Устойчивый)
Fiery Geyser->Fiery Geyser-(Изменение)
Shadow Weaver->Shadow Weaver-(Поток)
Solar Flare->Solar Flare-(Надежда)
Arcane Blight->Arcane Blight-(Пробуждение)
Enveloping Darkness->Enveloping Darkness-(Путь)
Fractured Glimmer->Fractured Glimmer-(Вызов)
Celestial Shield->Celestial Shield-(Подстраховка)
Shattering Echo->Shattering Echo-(Безмолвие)
Elusive Strike->Elusive Strike-(Покровительство)
Frost Lance->Frost Lance-(Сила)
Ethereal Burst->Ethereal Burst-(Грань)
Reckless Flames->Reckless Flames-(Устойчивость)
Gale Strike->Gale Strike-(Справедливость)
Shimmering Aura->Shimmering Aura-(Откровение)
Arcane Nova->Arcane Nova-(Телекинез)
Tornadic Blast->Tornadic Blast-(Устойчивость)
Unyielding Flames->Unyielding Flames-(Течение)




//////////////////////////////// Ископаемые //////////////////////////////////
Fossils->Ископаемые
Aberrant Fossil->Aberrant Fossil-(Искажённое ископаемое)
Aetheric Fossil->Aetheric Fossil-(Эфирное ископаемое)
Bloodstained Fossil->Bloodstained Fossil-(Окровавленное ископаемое)
Bound Fossil->Bound Fossil-(Связующее ископаемое)
Corroded Fossil->Corroded Fossil-(Пористое ископаемое)
Dense Fossil->Dense Fossil-(Плотное ископаемое)
Faceted Fossil->Faceted Fossil-(Гранёное ископаемое)
Fractured Fossil->Fractured Fossil-(Треснувшее ископаемое)
Frigid Fossil->Frigid Fossil-(Ледяное ископаемое)
Gilded Fossil->Gilded Fossil-(Позолоченное ископаемое)
Glyphic Fossil->Glyphic Fossil-(Резное ископаемое)
Hollow Fossil->Hollow Fossil-(Пустое ископаемое)
Jagged Fossil->Jagged Fossil-(Шероховатое ископаемое)
Lucent Fossil->Lucent Fossil-(Светлое ископаемое)
Metallic Fossil->Metallic Fossil-(Металлическое ископаемое)
Perfect Fossil->Perfect Fossil-(Безупречное ископаемое)
Prismatic Fossil->Prismatic Fossil-(Радужное ископаемое)
Pristine Fossil->Pristine Fossil-(Чистое ископаемое)
Sanctified Fossil->Sanctified Fossil-(Освящённое ископаемое)
Scorched Fossil->Scorched Fossil-(Опалённое ископаемое)
Serrated Fossil->Serrated Fossil-(Зубчатое ископаемое)
Shuddering Fossil->Shuddering Fossil-(Дрожащее ископаемое)
Tangled Fossil->Tangled Fossil-(Замысловатое ископаемое)
Deft Fossil->Deft Fossil-(Проворное ископаемое)
Fundamental Fossil->Fundamental Fossil(Фундаментальное ископаемое)

//////////////////////////////// Резонаторы //////////////////////////////////
Resonators->Резонаторы
Potent Chaotic Resonator->Potent Chaotic Resonator-(Активный хаотический резонатор) 

Powerful Chaotic Resonator->Powerful Chaotic Resonator-(Мощный хаотический резонатор) 

Prime Chaotic Resonator->Prime Chaotic Resonator-(Превосходный хаотический резонатор) 

Primitive Chaotic Resonator->Primitive Chaotic Resonator-(Простейший хаотический резонатор)


//////////////////////////////// Сущности //////////////////////////////////
Essences->Сущности
Deafening Essence of Torment->Deafening Essence of Torment-(Оглушающая сущность ненависти)
Deafening Essence of Wrath->Deafening Essence of Wrath-(Оглушающая сущность печали)
Deafening Essence of Spite->Deafening Essence of Spite-(Оглушающая сущность страдания)
Deafening Essence of Rage->Deafening Essence of Rage-(Оглушающая сущность ярости)
Deafening Essence of Anger->Deafening Essence of Anger-(Оглушающая сущность злобы)
Deafening Essence of Anguish->Deafening Essence of Anguish-(Оглушающая сущность горя)
Deafening Essence of Hatred->Deafening Essence of Hatred-(Оглушающая сущность мучения)
Deafening Essence of Sorrow->Deafening Essence of Sorrow-(Оглушающая сущность гнева)
Deafening Essence of Suffering->Deafening Essence of Suffering-(Оглушающая сущность неприязни)
Deafening Essence of Envy->Deafening Essence of Envy-(Оглушающая сущность зависти)
Deafening Essence of Woe->Deafening Essence of Woe-(Оглушающая сущность скорби)
Deafening Essence of Greed->Deafening Essence of Greed-(Оглушающая сущность жадности)
Deafening Essence of Contempt->Deafening Essence of Contempt-(Оглушающая сущность презрения)
Deafening Essence of Fear->Deafening Essence of Fear-(Оглушающая сущность страха)
Deafening Essence of Doubt->Deafening Essence of Doubt-(Оглушающая сущность сомнения)
Deafening Essence of Loathing->Deafening Essence of Loathing-(Оглушающая сущность отвращения)
Deafening Essence of Zeal->Deafening Essence of Zeal-(Оглушающая сущность усердия)
Deafening Essence of Misery->Deafening Essence of Misery-(Оглушающая сущность тоски)
Deafening Essence of Dread->Deafening Essence of Dread-(Оглушающая сущность жути)
Deafening Essence of Scorn->Deafening Essence of Scorn-(Оглушающая сущность насмешки)
Shrieking Essence of Torment->Shrieking Essence of Torment-(Визжащая сущность ненависти)
Shrieking Essence of Wrath->Shrieking Essence of Wrath-(Визжащая сущность печали)
Shrieking Essence of Spite->Shrieking Essence of Spite-(Визжащая сущность страдания)
Shrieking Essence of Rage->Shrieking Essence of Rage-(Визжащая сущность ярости)
Shrieking Essence of Anger->Shrieking Essence of Anger-(Визжащая сущность злобы)
Shrieking Essence of Anguish->Shrieking Essence of Anguish-(Визжащая сущность горя)
Shrieking Essence of Hatred->Shrieking Essence of Hatred-(Визжащая сущность мучения)
Shrieking Essence of Sorrow->Shrieking Essence of Sorrow-(Визжащая сущность гнева)
Shrieking Essence of Suffering->Shrieking Essence of Suffering-(Визжащая сущность неприязни)
Shrieking Essence of Envy->Shrieking Essence of Envy-(Визжащая сущность зависти)
Shrieking Essence of Woe->Shrieking Essence of Woe-(Визжащая сущность скорби)
Shrieking Essence of Greed->Shrieking Essence of Greed-(Визжащая сущность жадности)
Shrieking Essence of Contempt->Shrieking Essence of Contempt-(Визжащая сущность презрения)
Shrieking Essence of Fear->Shrieking Essence of Fear-(Визжащая сущность страха)
Shrieking Essence of Doubt->Shrieking Essence of Doubt-(Визжащая сущность сомнения)
Shrieking Essence of Loathing->Shrieking Essence of Loathing-(Визжащая сущность отвращения)
Shrieking Essence of Zeal->Shrieking Essence of Zeal-(Визжащая сущность усердия)
Shrieking Essence of Misery->Shrieking Essence of Misery-(Визжащая сущность тоски)
Shrieking Essence of Dread->Shrieking Essence of Dread-(Визжащая сущность жути)
Shrieking Essence of Scorn->Shrieking Essence of Scorn-(Визжащая сущность насмешки)
Essence of Delirium->Essence of Delirium-(Сущность бреда)
Essence of Hysteria->Essence of Hysteria-(Сущность истерии)
Essence of Insanity->Essence of Insanity-(Сущность безумия)
Essence of Horror->Essence of Horror-(Сущность ужаса)
Screaming Essence of Torment->Screaming Essence of Torment-(Кричащая сущность ненависти)
Screaming Essence of Wrath->Screaming Essence of Wrath-(Кричащая сущность печали)
Screaming Essence of Spite->Screaming Essence of Spite-(Кричащая сущность страдания)
Screaming Essence of Rage->Screaming Essence of Rage-(Кричащая сущность ярости)
Screaming Essence of Anger->Screaming Essence of Anger-(Кричащая сущность злобы)
Screaming Essence of Anguish->Screaming Essence of Anguish-(Кричащая сущность горя)
Screaming Essence of Hatred->Screaming Essence of Hatred-(Кричащая сущность мучения)
Screaming Essence of Sorrow->Screaming Essence of Sorrow-(Кричащая сущность гнева)
Screaming Essence of Suffering->Screaming Essence of Suffering-(Кричащая сущность неприязни)
Screaming Essence of Envy->Screaming Essence of Envy-(Кричащая сущность зависти)
Screaming Essence of Woe->Screaming Essence of Woe-(Кричащая сущность скорби)
Screaming Essence of Greed->Screaming Essence of Greed-(Кричащая сущность жадности)
Screaming Essence of Contempt->Screaming Essence of Contempt-(Кричащая сущность презрения)
Screaming Essence of Fear->Screaming Essence of Fear-(Кричащая сущность страха)
Screaming Essence of Doubt->Screaming Essence of Doubt-(Кричащая сущность сомнения)
Screaming Essence of Loathing->Screaming Essence of Loathing-(Кричащая сущность отвращения)
Screaming Essence of Zeal->Screaming Essence of Zeal-(Кричащая сущность усердия)
Screaming Essence of Misery->Screaming Essence of Misery-(Кричащая сущность тоски)
Screaming Essence of Dread->Screaming Essence of Dread-(Кричащая сущность жути)
Screaming Essence of Scorn->Screaming Essence of Scorn-(Кричащая сущность насмешки)
Remnant of Corruption->Remnant of Corruption-(След Порчи)
Wailing Essence of Torment->Wailing Essence of Torment-(Вопящая сущность ненависти)
Wailing Essence of Wrath->Wailing Essence of Wrath-(Вопящая сущность печали)
Wailing Essence of Spite->Wailing Essence of Spite-(Вопящая сущность страдания)
Wailing Essence of Rage->Wailing Essence of Rage-(Вопящая сущность ярости)
Wailing Essence of Anger->Wailing Essence of Anger-(Вопящая сущность злобы)
Wailing Essence of Anguish->Wailing Essence of Anguish-(Вопящая сущность горя)
Wailing Essence of Hatred->Wailing Essence of Hatred-(Вопящая сущность мучения)
Wailing Essence of Sorrow->Wailing Essence of Sorrow-(Вопящая сущность гнева)
Wailing Essence of Suffering->Wailing Essence of Suffering-(Вопящая сущность неприязни)
Wailing Essence of Woe->Wailing Essence of Woe-(Вопящая сущность скорби)
Wailing Essence of Greed->Wailing Essence of Greed-(Вопящая сущность жадности)
Wailing Essence of Contempt->Wailing Essence of Contempt-(Вопящая сущность презрения)
Wailing Essence of Fear->Wailing Essence of Fear-(Вопящая сущность страха)
Wailing Essence of Doubt->Wailing Essence of Doubt-(Вопящая сущность сомнения)
Wailing Essence of Loathing->Wailing Essence of Loathing-(Вопящая сущность отвращения)
Wailing Essence of Zeal->Wailing Essence of Zeal-(Вопящая сущность усердия)
Weeping Essence of Torment->Weeping Essence of Torment-(Плачущая сущность ненависти)
Weeping Essence of Wrath->Weeping Essence of Wrath-(Плачущая сущность печали)
Weeping Essence of Rage->Weeping Essence of Rage-(Плачущая сущность страдания)
Weeping Essence of Anger->Weeping Essence of Anger-(Плачущая сущность ярости)
Weeping Essence of Hatred->Weeping Essence of Hatred-(Плачущая сущность злобы)
Weeping Essence of Sorrow->Weeping Essence of Sorrow-(Плачущая сущность мучения)
Weeping Essence of Suffering->Weeping Essence of Suffering-(Плачущая сущность гнева)
Weeping Essence of Woe->Weeping Essence of Woe-(Плачущая сущность скорби)
Weeping Essence of Greed->Weeping Essence of Greed-(Плачущая сущность жадности)
Weeping Essence of Contempt->Weeping Essence of Contempt-(Плачущая сущность презрения)
Weeping Essence of Fear->Weeping Essence of Fear-(Плачущая сущность страха)
Weeping Essence of Doubt->Weeping Essence of Doubt-(Плачущая сущность сомнения)
Muttering Essence of Torment->Muttering Essence of Torment-(Бормочущая сущность ненависти)
Muttering Essence of Anger->Muttering Essence of Anger-(Бормочущая сущность печали)
Muttering Essence of Hatred->Muttering Essence of Hatred-(Бормочущая сущность злобы)
Muttering Essence of Sorrow->Muttering Essence of Sorrow-(Бормочущая сущность мучения)
Muttering Essence of Woe->Muttering Essence of Woe-(Бормочущая сущность скорби)
Muttering Essence of Greed->Muttering Essence of Greed-(Бормочущая сущность жадности)
Muttering Essence of Contempt->Muttering Essence of Contempt-(Бормочущая сущность презрения)
Muttering Essence of Fear->Muttering Essence of Fear-(Бормочущая сущность страха)
Whispering Essence of Hatred->Whispering Essence of Hatred-(Шепчущая сущность ненависти)
Whispering Essence of Woe->Whispering Essence of Woe-(Шепчущая сущность скорби)
Whispering Essence of Greed->Whispering Essence of Greed-(Шепчущая сущность жадности)
Whispering Essence of Contempt->Whispering Essence of Contempt-(Шепчущая сущность презрения)


//////////////////////////////// звери //////////////////////////////////
Beasts->Звери
Cave Beast->Cave Beast-(Пещерный зверь)
Enraptured Beast->Enraptured Beast-(Завороженный зверь)
Enraptured Beast->Enraptured Beast-(Завороженный зверь)
Primal Beast->Primal Beast-(Доисторический зверь)
The Alpha Beast->The Alpha Beast-(Первородный зверь)
Bone Cruncher->Bone Cruncher-(Костолом)
Hairy Bonecruncher->Hairy Bonecruncher-(Лохматый костолом)
Shaggy Monstrosity->Shaggy Monstrosity-(Косматая образина)
Thicket Hulk->Thicket Hulk-(Чащобная громадина)
Skeletal Beast->Skeletal Beast-(Костяк зверя)
Corrupted Beast->Corrupted Beast-(Искажённый зверь)
Armour Cruncher->Armour Cruncher-(Крушитель)
Forest Beast->Forest Beast-(Лесной зверь)
Goatman->Goatman-(Козерог)
Goatman Stomper->Goatman Stomper-(Козерог-топтун)
Bearded Devil->Bearded Devil-(Бородатый дьявол)
Alpine Devil->Alpine Devil-(Горный дьявол)
Bearded Devil->Bearded Devil-(Бородатый дьявол)
Goatman Shaman->Goatman Shaman-(Шаман козерогов)
Goatman Fire-raiser->Goatman Fire-raiser-(Козерог-заклинатель огня)
Bearded Shaman->Bearded Shaman-(Бородатый шаман)
Bearded Skycaller->Bearded Skycaller-(Бородатый призыватель небес)
Alpine Shaman->Alpine Shaman-(Горный шаман)
Hill Devil->Hill Devil-(Дьявол холма)
Colossus Crusher->Colossus Crusher-(Гигантский крушитель)
Arctic Wolf->Arctic Wolf-(Северный волк)
Snow Wolf->Snow Wolf-(Снежный волк)
Freezing Wolf->Freezing Wolf-(Морозный волк)
Dire Wolf->Dire Wolf-(Лютоволк)
Flame Hellion->Flame Hellion-(Огненный адский лев)
Dune Hellion->Dune Hellion-(Барханный адский лев)
Ruins Hellion->Ruins Hellion-(Адский лев из развалин)
Mountain Hellion->Mountain Hellion-(Горный адский лев)
Mountain Hellion Alpha->Mountain Hellion Alpha-(Горный адский лев-альфа)
Enslaved Hellion->Enslaved Hellion-(Порабощенный адский лев)
Enslaved Hellion->Enslaved Hellion-(Порабощенный адский лев)
Shackled Hellion->Shackled Hellion-(Пленённый адский лев)
Blood Ape->Blood Ape-(Кровавый примат)
Dread Primate->Dread Primate-(Жуткий примат)
Dread Primate->Dread Primate-(Жуткий примат)
Stygian Ape->Stygian Ape-(Адский примат)
Infested Ape->Infested Ape-(Заражённый примат)
Infested Ape->Infested Ape-(Заражённый примат)
Blood Chieftain->Blood Chieftain-(Вожак кровавых обезьян)
Carnage Chieftain->Carnage Chieftain-(Буйствующий вожак обезьян)
Stygian Silverback->Stygian Silverback-(Вожак адских обезьян)
Aboriginal Chieftain->Aboriginal Chieftain-(Вожак доисторических обезьян)
Host Chieftain->Host Chieftain-(Вожак-переносчик)
Host Chieftain->Host Chieftain-(Вожак-переносчик)
Carnage Ape->Carnage Ape-(Примат убийца)
Barrow Ape->Barrow Ape-(Холмовой примат)
Primitive Ape->Primitive Ape-(Примитивный примат)
Rhoa Mare->Rhoa Mare-(Самка роа)
Primordial Rhoa->Primordial Rhoa-(Доисторический роа)
Tercel Rhoa->Tercel Rhoa-(Роа-самец)
Murk Runner->Murk Runner-(Тёмный бегун)
Bone Rhoa->Bone Rhoa-(Костяной роа)
Corrupted Rhoa->Corrupted Rhoa-(Искажённый роа)
Bone Scavenger->Bone Scavenger-(Костяной роа-стервятник)
Zombie Rhoa->Zombie Rhoa-(Зомби-роа)
Infested Rhoa->Infested Rhoa-(Заражённый роа)
Gravel Eater->Gravel Eater-(Галечник)
Fossil Eater->Fossil Eater-(Ископаемый плевун)
Scrabbling Spitter->Scrabbling Spitter-(Плевун-копатель)
Granite Eater->Granite Eater-(Гранитный плевун)
Rock Spitter->Rock Spitter-(Каменный плевун)
Crustacean Sniper->Crustacean Sniper-(Рак-стрелок)
Crustacean Pelter->Crustacean Pelter-(Рак-метатель)
Infested Sniper->Infested Sniper-(Заражённый стрелок)
Obsidian Eater->Obsidian Eater-(Обсидиановый плевун)
Crustacean Sniper->Crustacean Sniper-(Рак-стрелок)
Merveil's Favoured->Merveil's Favoured-(Приближенный Мервейл)
Merveil's Daughter->Merveil's Daughter-(Дочь Мервейл)
Merveil's Attendant->Merveil's Attendant-(Свита Мервейл)
Merveil's Chosen->Merveil's Chosen-(Избранник Мервейл)
Merveil's Retainer->Merveil's Retainer-(Слуга Мервейл)
Singing Siren->Singing Siren-(Поющая сирена)
Merveil's Blessed->Merveil's Blessed-(Блаженная Мервейл)
Fated Siren->Fated Siren-(Сирена из пророчества)
Night Adder->Night Adder-(Ночной уж)
Host Adder->Host Adder-(Уж-переносчик)
Host Adder->Host Adder-(Уж-переносчик)
Bramble Cobra->Bramble Cobra-(Игольчатая кобра)
Host Cobra->Host Cobra-(Змей-переносчик)
Host Cobra->Host Cobra-(Змей-переносчик)
Acid Slitherer->Acid Slitherer-(Кислотный ползун)
Glade Mamba->Glade Mamba-(Лесной аспид)
Cursed Spawn->Cursed Spawn-(Проклятый ужас)
Fathom Screamer->Fathom Screamer-(Призрачный крикун)
Siren's Spawn->Siren's Spawn-(Выродок сирены)
Slimy Bloodsucker->Slimy Bloodsucker-(Мерзкий кровосос)
Foreseen Spawn->Foreseen Spawn-(Порождение пророчества)
Slimy Nemesis->Slimy Nemesis-(Мерзкий мститель)
Venomous Spawn->Venomous Spawn-(Ядовитый выродок)
Lurking Venom->Lurking Venom-(Таящийся отравитель)
Vaal Recluse->Vaal Recluse-(Отшельник ваал)
Noxious Tarantula->Noxious Tarantula-(Ядовитый птицеед)
Deadly Tarantula->Deadly Tarantula-(Смертоносный птицеед)
Leaping Spider->Leaping Spider-(Прыгающий паук)
Arakaali's Daughter->Arakaali's Daughter-(Дочь Аракаали)
Webbed Spider->Webbed Spider-(Затянутый паутиной паук)
Virulent Spider->Virulent Spider-(Ядовитый паук)
Ink Spinner->Ink Spinner-(Чернопряд)
Corrupted Arach->Corrupted Arach-(Заражённый арахнид)
Crypt Weaver->Crypt Weaver-(Подземельный ткач)
Mutant Arach->Mutant Arach-(Изуродованный арахнид)
Crypt Ambusher->Crypt Ambusher-(Могильный охотник)
Corrupted Spitter->Corrupted Spitter-(Ядовитый плевун)
Cave Skitterer->Cave Skitterer-(Пещерный легколап)
Spindle Spider->Spindle Spider-(Веретянщик)
Hatchling->Hatchling-(Малёк)
Brooding Tarantula->Brooding Tarantula-(Мрачный птицеед)
Buried Tarantula->Buried Tarantula-(Зарывающийся птицеед)
Maligaro's Inspiration->Maligaro's Inspiration-(Вдохновение Малигаро)
Enraptured Arachnid->Enraptured Arachnid-(Завороженный арахнид)
Enraptured Arachnid->Enraptured Arachnid-(Завороженный арахнид)
Fetid Maw->Fetid Maw-(Зловонная пасть)
Filth Maw->Filth Maw-(Мерзкая пасть)
Bestial Maw->Bestial Maw-(Звериная пасть)
Infested Maw->Infested Maw-(Заражённая пасть)
Infested Maw->Infested Maw-(Заражённая пасть)
Plumed Chimeral->Plumed Chimeral-(Пернатый ящер)
Feral Chimeral->Feral Chimeral-(Одичавший ящер)
Chrome-touched Chimeral->Chrome-touched Chimeral-(Зеркальный ящер)
Chrome-infused Chimeral->Chrome-infused Chimeral-(Хромовый ящер)
Wild Chimeral->Wild Chimeral-(Дикий ящер)
Chimeric Croaker->Chimeric Croaker-(Химеровый квакун)
Vaulting Croaker->Vaulting Croaker-(Скачущий квакун)
Chrome-touched Croaker->Chrome-touched Croaker-(Зеркальный квакун)
Chrome-infused Croaker->Chrome-infused Croaker-(Хромовый квакун)
Carrion Queen->Carrion Queen-(Матка трупоедов)
Carrion Swarmer->Carrion Swarmer-(Мерзкий жук)
Carrion Burrower->Carrion Burrower-(Мерзкий копатель)
Scum Crawler->Scum Crawler-(Сточник)
Nightmarish Carrion->Nightmarish Carrion-(Кошмарная гниль)
Nightmarish Crawler->Nightmarish Crawler-(Кошмарный ползун)
Avian Retch->Avian Retch-(Пернатый рыгатель)
Gluttonous Gull->Gluttonous Gull-(Ненасытный падальщик)
Sewage Crawler->Sewage Crawler-(Нечистотник)
Toxic Crawler->Toxic Crawler-(Ядовитый нечистотник)
Spine Serpent->Spine Serpent-(Шипастый змей)
Infested Serpent->Infested Serpent-(Заражённый змей)
Barb Serpent->Barb Serpent-(Колючюй змей)
Sand Serpent->Sand Serpent-(Песчаный змей)
Porcupine Goliath->Porcupine Goliath-(Дикобразный исполин)
Chrome-touched Goliath->Chrome-touched Goliath-(Зеркальный исполин)
Chrome-infused Goliath->Chrome-infused Goliath-(Хромовый исполин)
Devourer->Devourer-(Пожиратель)
Ancient Devourer->Ancient Devourer-(Старейший пожиратель)
Soulless Watcher->Soulless Watcher-(Безучастный смотритель)
Drifting Eye->Drifting Eye-(Плывущий глаз)
Cavern Drifter->Cavern Drifter-(Пещерный плывун)
Sewer Drifter->Sewer Drifter-(Сточный плывун)
Infected Watcher->Infected Watcher-(Заражённый смотритель)
Plummeting Ursa->Plummeting Ursa-(Падучий медведь)
Plummeting Ursa->Plummeting Ursa-(Падучий медведь)
Tunnelfiend->Tunnelfiend-(Верхолаз)
Tunnelfiend->Tunnelfiend-(Верхолаз)
Infested Tunnelfiend->Infested Tunnelfiend-(Заражённый верхолаз)
Infested Tunnelfiend->Infested Tunnelfiend-(Заражённый верхолаз)
Woods Ursa->Woods Ursa-(Лесной медведь)
Woods Ursa->Woods Ursa-(Лесной медведь)
Infested Ursa->Infested Ursa-(Заражённый медведь)
Infested Ursa->Infested Ursa-(Заражённый медведь)
Sickly Spinner->Sickly Spinner-(Больной паутинник)
Infected Spiker->Infected Spiker-(Заражённый иглогрив)
Infected Beast->Infected Beast-(Заражённый зверь)
Rabid Broodqueen->Rabid Broodqueen-(Заражённый вожак)
Rabid Minion->Rabid Minion-(Заражённый прислужник)
Crazed Chieftain->Crazed Chieftain-(Обезумевший вожак обезъян)
Putrid Chimeral->Putrid Chimeral-(Гниющая химера)
Infected Ambusher->Infected Ambusher-(Заражённая невидь)
Plummeting Ursa->Plummeting Ursa-(Падучий медведь)
Crazed Flamebeast->Crazed Flamebeast-(Обезумевший жарошкур)
Infected Rhoa->Infected Rhoa-(Заражённый роа)
Rabid Rhoa->Rabid Rhoa-(Бешеный роа)
Putrid Weaver->Putrid Weaver-(Гниющий ткач)
Infected Adder->Infected Adder-(Заражённый аспид)
Putrid Serpent->Putrid Serpent-(Гниющий змей)
Rabid Maw->Rabid Maw-(Бешеная пасть)
Fused Crawler->Fused Crawler-(Размякший панцерник)
Mindless Scavenger->Mindless Scavenger-(Безмозглый мусорщик)
Scavenging Vulture->Scavenging Vulture-(Всеядный гриф)
Rotting Vulture->Rotting Vulture-(Гниющий гриф)
Infested Vulture->Infested Vulture-(Заражённый гриф)
Dust Scrabbler->Dust Scrabbler-(Пыльный норовик)
Dust Scrabbler->Dust Scrabbler-(Пыльный норовик)
Dirt Scrabbler->Dirt Scrabbler-(Грязевой норовик)
Infested Skitterer->Infested Skitterer-(Заражённый легколап)
Lowlands Hopper->Lowlands Hopper-(Равнинный скакун)
Sand Skitterer->Sand Skitterer-(Песчаный быстроног)
Sand Leaper->Sand Leaper-(Песчаный прыгун)
Fury Hound->Fury Hound-(Огненный пёс)
War Hound->War Hound-(Боевой пёс)
Pitbull Demon->Pitbull Demon-(Демон-пёс)
Vicious Hound->Vicious Hound-(Яростная гончая)
Rooster Fiend->Rooster Fiend-(Исчадие-задира)
Rooster Demon->Rooster Demon-(Демон-задира)
Talon Archer->Talon Archer-(Когтистый лучник)
Feral Fowl->Feral Fowl-(Дикий кокатрикс)
Fighting Bull->Fighting Bull-(Бойцовый бык)
Avalanche Rider->Avalanche Rider-(Лавинный всадник)
Grazing Taurus->Grazing Taurus-(Пасущийся телец)
Savage Crab->Savage Crab-(Свирепый краб)
Infested Crawler->Infested Crawler-(Заражённый ползун)
Infested Crab->Infested Crab-(Заражённый краб)
Enraptured Crab->Enraptured Crab-(Завороженный краб)
Infested Crawler->Infested Crawler-(Заражённый ползун)
Bleached Crawler->Bleached Crawler-(Выбеленный ползун)
Echo of the Verdant->Echo of the Verdant-(Эхо зелени)
Echo of the Verdant->Echo of the Verdant-(Эхо зелени)
Maze Webspinner->Maze Webspinner-(Лабиринтный паутинник)
Maze Hatchling->Maze Hatchling-(Лабиринтный паучок)
Devourer->Devourer-(Пожиратель)
Maze Needleback->Maze Needleback-(Лабиринтный игольник)
Maze Slitherer->Maze Slitherer-(Лабиринтный ползун)
Parasite->Parasite-(Паразит)
Ravenous Parasite->Ravenous Parasite-(Голодный паразит)
Vicious Parasite->Vicious Parasite-(Ужасный паразит)
Poisonous Parasite->Poisonous Parasite-(Ядовитый паразит)
Plated Parasite->Plated Parasite-(Пластинчатый паразит)
Spitting Parasite->Spitting Parasite-(Паразит-плевун)
Brine Vassal->Brine Vassal-(Морской слуга)
Swarthy Mollusc->Swarthy Mollusc-(Тёмный моллюск)
Purge Hound->Purge Hound-(Гончая очищения)
Purge Hound->Purge Hound-(Гончая очищения)
Sulphurspawn->Sulphurspawn-(Серное отродье)
Plagued Arachnid->Plagued Arachnid-(Чумной арахнид)
Diseased Arachnid->Diseased Arachnid-(Отравленный арахнид)
Maligaro's Muse->Maligaro's Muse-(Муза Малигаро)
Hybrid Arachnid->Hybrid Arachnid-(Гибридный арахнид)
Scalding Arachnid->Scalding Arachnid-(Едкий арахнид)
Waste Lurcher->Waste Lurcher-(Сточный ползун)
Wild Rhex->Wild Rhex-(Дикий рекс)
Maternal Rhex->Maternal Rhex-(Созревший рекс)
Adolescent Rhex->Adolescent Rhex-(Рекс-детёныш)
Escaped Rhex->Escaped Rhex-(Беглый рекс)
Black Scorpion->Black Scorpion-(Чёрный скорпион)
Sulphuric Scorpion->Sulphuric Scorpion-(Серный скорпион)
Sand Scorpion->Sand Scorpion-(Песчаный скорпион)
Predatory Scorpion->Predatory Scorpion-(Хищный скорпион)
Mountain Lynx->Mountain Lynx-(Горная рысь)
Spider Crab->Spider Crab-(Краб-паук)
Skitterling->Skitterling-(Малёк-прыгун)
Azurite Widow->Azurite Widow-(Азуритовая вдова)
Cave Weta->Cave Weta-(Пещерный кузнечик)
Unstable Weta->Unstable Weta-(Нестабильный кузнечик)
Cavestalker->Cavestalker-(Пещерный охотник)
Azure Ape->Azure Ape-(Лазурный примат)
Gorgol Alpha->Gorgol Alpha-(Горгол-альфа)
Azure Shrieker->Azure Shrieker-(Лазурный визгун)
Charged Shrieker->Charged Shrieker-(Заряженный визгун)
Wild Bristle Matron->Wild Bristle Matron-(Дикая щетинистая матрона)
Wild Hellion Alpha->Wild Hellion Alpha-(Дикий адский лев-альфа)
Wild Brambleback->Wild Brambleback-(Дикий шипоспин)
Vivid Watcher->Vivid Watcher-(Буйный наблюдатель)
Vivid Vulture->Vivid Vulture-(Буйный стервятник)
Vivid Abberarach->Vivid Abberarach-(Буйный арахнион)
Primal Rhex Matriarch->Primal Rhex Matriarch-(Первобытная рекс-матриарх)
Primal Crushclaw->Primal Crushclaw-(Первобытный клешнелом)
Primal Cystcaller->Primal Cystcaller-(Первобытный наростень)
The Great White Beast->The Great White Beast-(Великий белый зверь)
The Great White Bones->The Great White Bones-(Великие белые кости)
Tyrannursus Maximus->Tyrannursus Maximus-(Тиранурсус Максимус)
Elder-Blessed Goatman->Elder-Blessed Goatman-(Благословленный Древним козерог)
The Faun->The Faun-(Фавн)
Ungulath->Ungulath-(Унгулат)
Elder-Blessed Hellion->Elder-Blessed Hellion-(Благословленный Древним адский лев)
The Burning Menace->The Burning Menace-(Горящая угроза)
Nadia the Soothing->Nadia the Soothing-(Надя Кроткая)
Aidan the Frenzied->Aidan the Frenzied-(Эйдан Бешеный)
Hollowskull, the Willing Host->Hollowskull, the Willing Host-(Пусточереп, Послушный переносчик)
Elder-Blessed Rhoa->Elder-Blessed Rhoa-(Благословленный Древним роа)
Albino Rhoa->Albino Rhoa-(Роа-альбинос)
Oozeback Bloom->Oozeback Bloom-(Илистый грязеспин)
Ventarus->Ventarus-(Вентарус)
The Dweller of the Deep->The Dweller of the Deep-(Обитатель глубин)
Ambrosia, Daughter of Merveil->Ambrosia, Daughter of Merveil-(Амброзия, дочь Мервейл)
Amarissa, Daughter of Merveil->Amarissa, Daughter of Merveil-(Амарантия, дочь Мервейл)
Brood Princess->Brood Princess-(Царевна выводка)
Scrabbling Menace->Scrabbling Menace-(Царапающая угроза)
Cave Crustacean->Cave Crustacean-(Пещерный краб)
Invading Crustacean->Invading Crustacean-(Нападающий краб)
Infested Crustacean->Infested Crustacean-(Заражённый краб)
Deep Crustacean->Deep Crustacean-(Глубинный краб)
Deep Crustacean->Deep Crustacean-(Глубинный краб)
Shield Crab->Shield Crab-(Крепкий краб)
Bleached Crustacean->Bleached Crustacean-(Иссушенный краб)
Elder-Blessed Cobra->Elder-Blessed Cobra-(Благословленная Древним кобра)
Unstable Larva->Unstable Larva-(Нестабильный кальмар)
Black Death->Black Death-(Чёрная смерть)
The Weaver->The Weaver-(Ткачиха)
Balah, Duke->Balah, Duke-(Бала)
Paradisae Venenum->Paradisae Venenum-(Райский Ядоклюв)
Carrion Minion->Carrion Minion-(Мерзкий выродок)
Elder-Blessed Retch->Elder-Blessed Retch-(Благословленный Древним рыгатель)
Thistlesage->Thistlesage-(Чертополох)
Spirit of Nadia->Spirit of Nadia-(Дух Нади)
Spirit of Aidan->Spirit of Aidan-(Дух Эйдана)
Tunnelworm->Tunnelworm-(Подземный поглотитель)
The Conqueror Wurm->The Conqueror Wurm-(Змей Завоеватель)
Mystic Devourer->Mystic Devourer-(Таинственный пожиратель)
Q'uru->Q'uru-(К'уру)
The All-seeing Eye->The All-seeing Eye-(Всевидящее око)
The All-seeing Eye->The All-seeing Eye-(Всевидящее око)
Konu, Maker of Wind->Konu, Maker of Wind-(Кону, Гонитель ветров)
Konu, Maker of Wind->Konu, Maker of Wind-(Кону, Гонитель ветров)
Sheaq, Maker of Floods->Sheaq, Maker of Floods-(Шиак, Собиратель туч)
Sheaq, Maker of Floods->Sheaq, Maker of Floods-(Шиак, Собиратель туч)
Kamaq, Soilmaker->Kamaq, Soilmaker-(Кэмак, Маратель)
Kamaq, Soilmaker->Kamaq, Soilmaker-(Кэмак, Маратель)
Inti of the Blood Moon->Inti of the Blood Moon-(Инти Кроваволунный)
Inti of the Blood Moon->Inti of the Blood Moon-(Инти Кроваволунный)
Simi, the Nature Touched->Simi, the Nature Touched-(Сими, Помазанный природой)
Simi, the Nature Touched->Simi, the Nature Touched-(Сими, Помазанный природой)
The Sunburst Queen->The Sunburst Queen-(Солнцеликая царица)
The Sunburst Queen->The Sunburst Queen-(Солнцеликая царица)
Cintiq, the Inescapable->Cintiq, the Inescapable-(Синтик, Неотвратимый)
Cintiq, the Inescapable->Cintiq, the Inescapable-(Синтик, Неотвратимый)
Thornrunner->Thornrunner-(Шипоносец)
Thornrunner->Thornrunner-(Шипоносец)
Mother of the Hive->Mother of the Hive-(Королева улья)
Rima, Deep Temptress->Rima, Deep Temptress-(Рима, Греховодница из глубин)
Rima, Deep Temptress->Rima, Deep Temptress-(Рима, Греховодница из глубин)
Quetzerxi->Quetzerxi-(Квецеркси)
Marrowcrush->Marrowcrush-(Костомел)
The Cadaver Bull->The Cadaver Bull-(Бодливый остов)
Junglemare->Junglemare-(Мать джунглей)
Blood Stasis->Blood Stasis-(Кровавый усыпитель)
Blood Morpher->Blood Morpher-(Кровавый погонщик)
Spinesnap->Spinesnap-(Кусака)
Genesis Paradisae->Genesis Paradisae-(Порождение рая)
Death from Above->Death from Above-(Смерть свыше)
Guardian of the Mound->Guardian of the Mound-(Страж кургана)
Alpha Paradisae->Alpha Paradisae-(Райский вожак)
Mother of the Swarm->Mother of the Swarm-(Мать роя)
Deathflutter->Deathflutter-(Смертоносец)
Bladetooth->Bladetooth-(Сталезуб)
Wrigglechaw->Wrigglechaw-(Пеленатель)
Blinkflame->Blinkflame-(Мерцающий пламень)
The Duchess->The Duchess-(Матрона)
Shivershell->Shivershell-(Ледяной панцирь)
Razorleaf->Razorleaf-(Страшный душитель)
Stranglecreep->Stranglecreep-(Медноклык)
Pewterfang->Pewterfang-(Бледная вдова)
Bladeback Guardian->Bladeback Guardian-(Шипастый страж)
Strangledrift->Strangledrift-(Парящий душитель)
Ghostram->Ghostram-(Призрачный таранщик)
Risen Infested Beast->Risen Infested Beast-(Остов заражённого зверя)
Mutated Ursa->Mutated Ursa-(Мутировавший медведь)
Mutated Watcher->Mutated Watcher-(Мутировавший смотритель)
Mutated Broodqueen->Mutated Broodqueen-(Мутировавший вожак)
Mutated Croaker->Mutated Croaker-(Мутировавший квакун)
Mutated Arachnid->Mutated Arachnid-(Мутировавший арахнид)
Twisted Chimeral->Twisted Chimeral-(Исковерканный ящер)
Mutated Flamebeast->Mutated Flamebeast-(Мутировавший жарошкур)
Mutated Winterclaw->Mutated Winterclaw-(Мутировавший хладокраб)
Mutated Chieftain->Mutated Chieftain-(Мутировавший вожак обезьян)
Mutated Rhoa->Mutated Rhoa-(Мутировавший роа)
Mutated Adder->Mutated Adder-(Мутировавший аспид)
Mutated Maw->Mutated Maw-(Мутировавшая пасть)
The Hundred Foot Shadow->The Hundred Foot Shadow-(Стофутовая тень)
Raihara, Tukohama's Loyal->Raihara, Tukohama's Loyal-(Раихара, приверженец Тукохамы)
Steelchaw->Steelchaw-(Стальной жевун)
Eyepecker->Eyepecker-(Глазохват)
Boulderback->Boulderback-(Камнеспин)
Mutewind Lynx->Mutewind Lynx-(Рысь из Немого ветра)
Echo of the Verdant->Echo of the Verdant-(Эхо зелени)
Echo of the Verdant->Echo of the Verdant-(Эхо зелени)
Blue Frog->Blue Frog-(Голубая лягушка)
Common Frog->Common Frog-(Обычная лягушка)
Strange Frog->Strange Frog-(Странная лягушка)
The Encephalophage->The Encephalophage-(Энцефалофаг)
Lola, the Fierce->Lola, the Fierce-(Лола, Свирепая)
Rocco, the Bloodthirsty->Rocco, the Bloodthirsty-(Рокко, Жаждущий крови)
Brinecrack->Brinecrack-(Морской щелкун)
Tamulus->Tamulus-(Тамалус)
Tamipin->Tamipin-(Тамипин)
The Basilisk->The Basilisk-(Василиск)
Saqawine Rhex->Saqawine Rhex-(Рекс Сакаваля)
Saqawal, First of the Sky->Saqawal, First of the Sky-(Сакаваль, Первый Неба)
Saqawine Rhoa->Saqawine Rhoa-(Роа Сакаваля)
Saqawine Vulture->Saqawine Vulture-(Гриф Сакаваля)
Saqawine Retch->Saqawine Retch-(Рыгатель Сакаваля)
Saqawine Cobra->Saqawine Cobra-(Кобра Сакаваля)
Saqawine Blood Viper->Saqawine Blood Viper-(Кровавая гадюка Сакаваля)
Saqawine Chimeral->Saqawine Chimeral-(Ящер Сакаваля)
Farric Flame Hellion Alpha->Farric Flame Hellion Alpha-(Адский лев-альфа Фаррул)
Farric Frost Hellion Alpha->Farric Frost Hellion Alpha-(Морозный адский лев Фаррул)
Farric Lynx Alpha->Farric Lynx Alpha-(Рысь-альфа Фаррул)
Farric Tiger Alpha->Farric Tiger Alpha-(Тигр-альфа Фаррул)
Farrul, First of the Plains->Farrul, First of the Plains-(Фаррул, Первая Равнин)
Farric Wolf Alpha->Farric Wolf Alpha-(Волк-альфа Фаррул)
Craiceann, First of the Deep->Craiceann, First of the Deep-(Краценн, Первый Глубин)
Fenumal Queen->Fenumal Queen-(Королева Фенумы)
Fenumal Scrabbler->Fenumal Scrabbler-(Норовик Фенумы)
Fenumal Devourer->Fenumal Devourer-(Пожиратель Фенумы)
Fenumal Scorpion->Fenumal Scorpion-(Скорпион Фенумы)
Fenumal Plagued Arachnid->Fenumal Plagued Arachnid-(Чумной арахнид Фенумы)
Fenumal Hybrid Arachnid->Fenumal Hybrid Arachnid-(Гибридный арахнид Фенумы)
Fenumus, First of the Night->Fenumus, First of the Night-(Фенума, Первая Ночи)
Fenumal Widow->Fenumal Widow-(Вдова Фенумы)
Farric Goliath->Farric Goliath-(Исполин Фаррул)
Farric Taurus->Farric Taurus-(Телец Фаррул)
Farric Chieftain->Farric Chieftain-(Вождь Фаррул)
Farric Ape->Farric Ape-(Примат Фаррул)
Farric Goatman->Farric Goatman-(Козерог Фаррул)
Farric Magma Hound->Farric Magma Hound-(Магмовая гончая Фаррул)
Farric Pit Hound->Farric Pit Hound-(Подземная гончая Фаррул)
Farric Gargantuan->Farric Gargantuan-(Громадина Фаррул)
Farric Ursa->Farric Ursa-(Медведь Фаррул)
Craicic Sand Spitter->Craicic Sand Spitter-(Песчаный плевун Краценна)
Craicic Shield Crab->Craicic Shield Crab-(Крепкий краб Краценна)
Craicic Savage Crab->Craicic Savage Crab-(Свирепый краб Краценна)
Craicic Spider Crab->Craicic Spider Crab-(Краб-паук Краценна)
Craicic Maw->Craicic Maw-(Пасть Краценна)
Craicic Chimeral->Craicic Chimeral-(Ящер Краценна)
Craicic Vassal->Craicic Vassal-(Слуга Краценна)
Craicic Squid->Craicic Squid-(Кальмар Краценна)
Craicic Watcher->Craicic Watcher-(Смотритель Краценна)
The Black Mórrigan->The Black Mórrigan-(Чернокрылая Морриган)


Economy->Экономика
Name->Название
Value->Стоимость
Last 7 days->Последние 7 дней
Listed->Количество
Tier->Уровень
Buying price->Цена покупки
Selling price->Цена продажи
Buy->Купить
Sell->Продать
Not enough data->Недостаточно данных
Trade->Торговля